月色如金波|揽之欲盈手|如何不解饮|空遣星名酒
去岁春归日|与君成别离|今年春又到|君尚客天涯
一念周沙界|日用万般通|湛然常寂灭|常展自家风
一壶情所寄|四句意能多|秋到无诗酒|其如月色何
空青老仙伯|有子爱溪山|谁信南坡路|依依泉石间
燕然高插天|烟霞日来往|而君处其间|飘凌动遐想
远来亦忌饱|出去不妨饥|向水莫许骤|偏伤肺与脾
雨后残霞褪|风前碎锦飞|自知春已去|敢恨蝶来稀
杰阁临无地|仙家小洞天|循檐自来往|非雾亦非烟
带从内府颁|枕出古陵间|却笑韩宣子|区区爱一环
尽识参无毒|明知堇有灾|安知尝试者|百死百生来
闲登溪上楼|返照射溪水|何处榜声来|前滩白鸥起
惊梦猿三咽|窥帷月一痕|无人空犬吠|依旧掩柴门
山高径路微|林深茅屋小|读易者何人|焚香坐清晓
阆苑红初露|瑶池碧半涵|春生从太极|化洽本周南
公子将归雁|幽娥不带花|愿言速成茧|鸣鴂事青麻
旧事参差梦|新程逦迤秋|故人如见忆|时到寺东楼
高台见百里|长啸海风生|为问尘埃耳|能闻鸾鹤声
巢穴通霄眼|尘劳无住心|经行及坐卧|万古至于今
阴丛含雨气|燥叶领风声|即是图边见|犹令客况清
虚空无处所|髣髴似琉璃|诗境何人到|禅心又过诗
暑气晓来清|时时闻远莺|还思故园路|松下绿苔生
拟毡安可卷|欲器不禁锤|俯拾甘赪手|昂窥任扑腮
谁把名鹰爪|天然状不殊|无心事搏击|中有鸟相呼
山上天将近|人间路渐遥|谁当云里见|知欲渡仙桥
茗碗梦中觉|荷花镜里香|凉生只当处|暑退亦无方
好花容易褪|恶草自然生|我亦徙憎爱|无情对有情
毫端不及处|精神殊可掬|靡靡听谈玄|六月添重服
梅花老山林|思与天下芳|琼花差清白|荐之守维扬
徙穴中庭蚁|争巢后圃鸠|物情犹虑患|人事得忘忧
栖鸡已登屋|宿羽复归林|不语听钟坐|默默千里心
登台不见月|空有列星光|北斗涌地出|西风吹众芳
岳力偏幽最|平遥眼一新|得从烟月望|拟作钓江人
岁晚节自抱|足见有心哉|游人从何处|带得春风来
圣主勤恤民|贪夫昧罪己|天听岂不近|骎骎未知止
不食至七日|能将礼自居|既然严像设|亦复奠朝晡
两仪坤载厚|四海母仪深|愿上菖花酒|年年圣子心
楼前淮水上|远树似鱼鳞|来帆与去棹|肠断倚栏人
帝驾陷尘沙|孤臣誓靡他|丹心期报主|白发不知家
笛弄林间月|蓑披陇上云|朱门半消歇|人笑不如君
饱食卧北窗|多少恩难补|征人捍边陲|农夫劳畎亩
霜绡才半幅|描写尽中华|城郭山林里|穷愁未有涯
逃不从幼安|放非效玄真|愿事尧舜主|或与夔龙亲
送别垂杨下|泪沾树上花|晓风吹不尽|飘泊到天涯
拥被听春雨|残灯一点青|吾儿归渐近|何处宿长亭
佳人负红颜|家在白茅渚|独怜形影时|东风一延伫
酌泉咽冰玉|肺腑生惨凛|老夫桑苎家|颇欲续水品
古木被高荫|昼坐不知暑|会得古人心|开襟静无语
天风一夜霜|萧然见秋野|兰蕙化为茅|亦有不化者
门冬如佳隶|长年护阶除|生儿乃不凡|磊落玻璃珠
珍重焦延寿|诸孙尚有碑|云何多畏忌|不著撰人谁
仲冬白门柳|维舟露梢影|日暮乌不栖|天空踏枝冷
修廊行复怯|风吹合欢带|小立避游人|佯对香炉拜
谷静鸟飞绝|天空云度闲|尔时一回首|眼底无青山
雨过津如拭|云低岛欲连|仙舟同李郭|遍适海门天
滥泉沸山巅|汍泉迸山足|一鹭饮东泉|飞向西泉浴
时携一觚酒|独向花间醉|不分汝南翁|春风自天地
饙气初郁勃|炊爨复氤氲|室中久无妇|莫讶阳台云
澄练正萦槛|高屏近拥门|偏宜云惨澹|更好月黄昏
出水芙蕖色|娟娟不异花|疗饥还疗热|菱芡未须夸
钓濑云山外|岩花瀑布边|却疑方处士|诗思涌成泉
山似九折坂|河非八节滩|跻攀复揭厉|奈此行路难
与君话无生|嗒然丧其我|静作礼空王|何处证因果
我有一寸绠|能汲万古泉|无人同此意|闲看水中天
方寻莲境去|又值竹房空|几韵飘寒玉|馀清不在风
客子灯前酒|梅花雪后天|不须横玉笛|春意满山川
野宿秋云暝|溪行晓雾寒|归心与明月|夜夜到长安
地暖树未凋|腊残梅欲放|无端景物奇|妆点诗怀壮
平生方寸心|誓开玄冥北|岁暮日月疾|我叹黑头白
松林度鸟急|鹫岭巢云低|欲问莲花社|斜阳过虎溪
下瞰十仞馀|遥瞻几千里|游客日暮时|乡心万端起
海棠花未开|枝上春禽语|东风几何时|满地飞红雨
流水当屋角|藕花绕四围|采莲冒山雨|荷叶盖头归
醉里忘形客|山中化石仙|翻同醒酒伴|作对媚平泉
秋晚稻生孙|催科不到门|人闲牛亦乐|随意过前村
端居得韵语|不作凉秋悲|快若弹丸转|知是王家诗
乡庐暗边尘|时移而事变|结屋漫逍遥|可想不可见
衣如当日白|花似昔年黄|拟问东篱事|寒香入杳茫
春衣裁剪罢|密叶间秾花|缝到鸳鸯处|行行线脚斜
马姊为玉浆|色如红玛瑙|醉来毡帐眠|不觉情颠倒
雪冒禹碑石|云埋泌草堂|早知抱遗恨|悔不挟乾粮
上方古栋宇|年久自参差|动我行人想|相看各赋诗
绝壁上千寻|隐约岩栖处|笙鹤去不还|人间自今古
有松堪系马|遇钵更投针|记得汤师句|高禅助朗吟
天连湖面阔|山到水边回|斜月挂郢树|虚舟傍石牌
水旱尧汤有|先天数可推|圣君得贤相|翻是太平时
芦深可藏人|下有扁舟泊|正似洞庭风|日莫孤帆落
夏日飞火云|枕簟访深僻|坐此松竹林|冰泉嗽寒石
城倚红云下|门临绿水滨|宝鞍驰骏马|多是帝京人
人情乐安肆|昼夜物欲婴|惟敬以直之|山立而川行
明日添一岁|端忧奈尔何|冲寒出洞口|犹校夕阳多
莫上翠楼看|望见官城渡|垂柳碧于𥮾|是郎去时路
结心缠万缕|结缕几千回|结怨无穷极|结心终不开
湖深山影碧|天净月光空|幸自无波浪|苹花谩晚风
酴醾春意好|百尺走条枚|壁立堆香雪|风流入酒杯
山僧汲空潭|惊起二龙子|百里云冥濛|三日雨不止
银缸羞作花|荧荧照锦簟|为问双眉长|何如三妇艳
秋云淡无色|溪树红可怜|是谁来领略|钓罢老渔船
进步咫尺间|一落不复上|安得勒将军|为我牵百丈
回环拥冈峦|澶漫分林坞|纵目以怡情|信美疑吾土
枕上雨初歇|庭前花乱开|春风在高树|啼鸟去还来
谷口人未归|凉风满林樾|孤村云气深|千山雨初歇
未开先食蕾|虫细若飞丝|叶底粉如雪|香宜月上时
帘外燕翩翩|归时在社前|不辞飞渡海|来看赛丰年
山崦少人渡|夕阳横钓艖|颠风捲重阴|急浪扬层波
疏林寒有叶|野水净无风|潮声孤枕到|秋色一江空
绿波回断港|青嶂荫孤村|谷萝开乱莽|汀浪浸疏园
真人栖隐处|洗药有清池|金丹要沐浴|玉水自生肥
盘石以为磴|萦纡上翠岑|披云瞩佳境|适此慰登临
却嫌暄暖甚|未腊已开残|么凤莫收去|留香过岁寒
丈夫怀远志|儿女苦参商|过海防风浪|何当归故乡
江明雨初歇|山暗云犹湿|未可动归桡|前程风浪急
晓碧上栏干|暖风乍飏扇|春台雨露深|如对君王面
至音不可收|今人滞形器|欲知古乐心|山中此声是
脆绿怜弱干|勿为霜雪侵|春风动雷雨|须长一千寻
日暮沧江上|天寒水自波|孤舟宜早泊|风浪夜应多
潮去闸头浅|潮来闸头深|浅深浑有定|不似世人心
昏昏俱守默|皎皎欲谁怜|讵意林和靖|年来亦尚玄
彭老有许恨|杜陵无句诗|如何春后赏|却是折来枝
清晨谒承明|百官仍依依|回立讯中使|君王何时归
我昔临此州|民容拙使君|子行为多谢|慰彼无毫分
京国初归日|江门晚渡时|幽怀写不尽|鱼鸟自忘机
朝向南洲行|暮向南洲宿|不钓亦不泛|爱看南洲绿
红豆生南国|秋来发故枝|愿君多采撷|此物最相思
终不得自在|即此苦何穷|愿取杨枝水|一洒朔庭空
尘中一百年|洞里一弹指|先人瞬息间|见我九经此
羌笛悲残曲|含章忆素英|关情使君阁|诗雪夜同清
解貂换美酒|半与美人醉|留半伴山翁|夜深谈世事
落叶带回吹|荒筠冒幽石|池上鸟鸣时|闲斋掩秋夕
泉争乱石穿|松激回飙响|山经读未终|猿啼孤月上
出郭望前山|溪行夕照间|诗成无和者|独跨蹇驴还
病骨倦空林|曳杖闲庭步|暗烛与寒虫|迢迢思风露
茑萝千尺翠|托根傍孤松|珍重岁寒侣|缠绵意几重
三阁变瓦砾|欢乐一时休|草没石井栏|草亦为汝羞
顺谀要领绝|书罢付函封|隶子方求益|君非卖菜佣
援琴对五岳|流响入青云|犹胜四壁立|独拥卓文君
经时久枯槁|得水即青葱|起死医无药|返魂香有功
积雪园林暮|春光独满枝|玉人闲对此|清淡最相宜
旧闻南华仙|作吏漆园里|应悟见割忧|嗒然空隐几
峨峨七尺躯|不及薄铜钱|塞外多霜雪|犹云得所天
静夜飒灵风|神君语帐中|至今双白鹄|时下五云峰
赤壁临烟水|仙人鞭石来|清风来水面|荡漾斗牛洄
不有焦尾人|谁知中郎赏|所以琴上丝|千秋发哀响
泪烛黯将灭|啼乌耿未眠|暗风吹湿梦|夜雨忽连年
一径绿阴去|隐隐花竹幽|主人地行仙|终日杖屦游
塞北为君戍|江南是妾家|遥知关外雪|只似岭头花
岳下无耆老|何从访旧闻|不知紫岩墓|更隔几重云
年老睡还少|夜长醒更多|土床烟火足|趺坐默吟哦
处处品泉流|争名不相下|岂无幽涧中|清恐人知者
暧暧村烟暮|牧童出深坞|骑牛不顾人|吹笛寻山去
高台郁嵯峨|苔色亦已古|无人看日圭|昼夜自子午
日斜未理妆|昼长人易倦|回扑砚上蝇|墨花溅团扇
上林故多蛙|尔声何喧阗|忽感自得意|写之观物篇
春色多红紫|秋香尚白黄|良工亦何意|随手作低昂
孤𪩘秀何似|碧莲含未开|谁将修月斧|𣃁取一尖来
鸳鸯离别伤|人意似鸳鸯|试取鸳鸯看|多应断寸肠
人子勤于孝|无时志不存|夜来安寝息|早起问寒暄
一道香蒲水|奔流下翠微|醉起弄珠箔|回风捲雪飞
未是他乡客|思家已断魂|明朝春色好|宿处近花村
采采篱边菊|羞将插帽纱|却疑秋富贵|天地也奢华
山馆长寂寂|闲云朝夕来|空庭复何有|落日照青苔
停骖望箕山|山色翠欲滴|美人招不来|清风满泉石
戚戚鸣岁暮|不知有春秋|肯信鲲与鹏|同作逍遥游
画君年少时|如今君已老|今时新识人|知君旧时好
老蟾明孤心|凉飙苏病骨|保此中夜存|微阳有毫发
春夕慈闱永|瑶池乐未央|管弦声合奏|灯月影交光
采采石上兰|萧萧水边竹|各抱夷齐心|清风激流俗
空闻榴五色|幽隐隔蓬莱|想在慈山里|云深长绿苔
晓佩摇苍玉|晨旗亚翠斿|新年好春色|今日满皇州
停云独倚阑|扣门问来使|云是张公子|永昌送诗至
□日过人日|开关始一游|天运长不息|新萌亦复抽
彭仙乘鹤去|闲室閟松阴|明月自来照|白云闲到今
落落幽涧石|飘飘坠叶风|妾情无久暂|君去有西东
宛转复宛转|真金休百炼|丧却毗耶离|无人解看箭
青天日如赫|亭午一星明|不敢论玄象|私心想太平
箫能妻弄玉|琴可挑文君|吹彻宁哥笛|梅妃未必闻
日净芙蓉远|春明芍药长|谁怜玉蝴蝶|正似锦鸳鸯
山居注玄穆|萝径寡轮驷|时有蓑笠人|携壶问奇字
清景持芳菊|凉天倚茂松|名山何必去|此地有群峰
红树裹青山|树里闻人语|遥问隔林僧|江村何处去
高峰御皎月|深壑泻飞湍|谁来白云里|与汝凭栏看
暮霭忽苍然|前山日将落|扁舟早归来|湖上风色恶
念别三年久|相望一舍间|无人寄消息|风雨暗前山
等闲移作塞|郑重喝成卢|莫看文怀瘦|胸吞几寄奴
晚日催弦管|春风入绮罗|杏花如有意|偏落舞衫多
寂寞云深地|山空叶落时|自怜为隐僻|莫恨月来迟
面折公孙子|堂堂负直声|安知上前议|那复有黄生
舟过嘉鱼县|买鱼人道无|青山不堪煮|弹铗看铜符
东寺留连饮|张园烂漫游|儿童望归路|一日几登楼
苍苍秋月凉|飒飒寒芦短|孤舟人未眠|霜花扑窗满
秋色飘零里|秋声淅沥中|碧云归雁尽|天末夕阳红
四十明朝是|频闻画鼓挝|残灯持自照|忽吐两三花
孤芳寡所合|百合种何因|恐尔清高病|冥途忤俗人
百里犹乡土|千年亦比邻|愿言培世德|未敢咏维新
咄哉灵运辈|竟坐衣冠辱|谁知五柳家|春雨东皋绿
愿作合欢草|夜则为一茎|与郎缠绵死|地下犹相并
朝发方良矶|莫宿白水湾|宽作一月程|须见江南山
钓艇收缗尽|昏鸦接翅归|月生初学扇|云细不成衣
渐止牛羊牧|还添雨露滋|但令萌檗长|自有岁寒姿
佛相本来空|坠地涅槃竟|久持贝多言|不垢亦不净
春花狼藉馀|六出净烦热|衲衣凝夜禅|香散深林月
商山千年菌|一朝化为石|莫令鲍靓过|截作中时食
润壑千岁资|风声万牛吼|春江縠纹面|一笑可忍不
眼心俱忆念|心眼共追寻|谁家解事眼|副著可怜心
芳时谈古调|霅浦少人同|化日桃花外|归船便隔春
有路沿云断|无人但鸟呼|半山御落日|始觉客怀孤
静院幽花馥|空庭皓月明|春寒夜更好|未有一虫鸣
池中寒冰澌|原上春草生|用心如明镜|不将亦不迎
孤峰真崛奇|凝目见太古|便悲江上山|培𪣻不足数
礼经涤匕出|叱狗不言焉|一旦鲍妻去|那知在母前
风艳霏霏去|羁人处处游|明年纵相见|不在此枝头
粗粝可克腹|生涯实有馀|尽除今世事|留得古人书
凉气度芳洲|香来水正流|时闻采莲曲|不见采莲舟
溪水虽多曲|舟行不惮赊|山山秋树赤|犹复似桃花
满室暗香浮|梅边列经史|调羹自有时|待结枝头子
鸣蜩惊早夏|斗草及良辰|共荐菖华酒|君王寿万春
饱我德更勤|青州两从事|酣饮愧无言|未尝识奇字
入林无俗物|爱客有深怀|谁得逍遥趣|风吹海月来
连峰沙似雪|迢递带沧波|好是残阳外|人稀野鸟多
徘徊立泉上|谁敢酌寒清|莫解金凿落|且听玉琮琤
君辞九州长|瓢挂泉头树|洗耳莫临流|恐有饮牛去
爵并开乡邑|官皆视大蓬|年龄高略似|须发黑难同
冬季口中黑|医之不必痊|卧蚕虽有色|而退也无缘
肌肤剪秋水|垂云出龙宫|我意得子佩|笑许无言中
遥岑谁画卦|置此荆山鼎|乍可姹女飞|千秋觇溟涬
欲息何情思|良犹本不真|群心皆有异|老尽少年人
岱宗天下秀|霖雨遍人间|高卧今何在|东山似此山
洞门双玉扇|隔岫窥云雾|袅袅三石梁|苔滑不敢度
一种天香异|千株国色倾|应怜花似脸|半醉倚华清
满地碎珠玑|向日腾光彩|昨梦穷河源|天澄万星海
绝塞闻征雁|疏篱隐候虫|故园添白发|今夕又秋风
临池写来禽|坐石呼格五|森森苍雪寒|九夏失炎午
江上多舟楫|山中有路岐|那能不来往|终是两相宜
日落西陵渡|秋来姻草萋|已无孔九在|谁问若耶溪
森森灌木阴|渺渺澄江静|一棹独垂纶|中流钓山影
湖上香稻熟|湖中鲤鱼长|网鱼煮香稻|千载荐桐香
古寺无碑刻|僧云不记年|自馀安所问|惟是爱林泉
与君共一体|有如云与霞|何意狂风吹|片片委泥沙
候火夜铛煖|松风数沸腾|茶烟轻袅袅|迥出白云层
支离抛岁月|曼衍拓心胸|好泛杯中蚁|闲消匣底龙
连理庭中木|丛生坐侧芝|未尝闻孝感|一一有兹奇
川原何缭绕|开阁吞八九|为问阁中人|望见长安不
淮上能无雨|回头总是情|蒲帆浑未织|争得一欢成
客心仍在楚|江馆复临湘|别意猿鸟外|天寒桂水长
仰服籯金训|传家在一经|况当声教远|夜柝静戎亭
岁暮白日速|风高黄叶稀|归心与寒雁|一夜向南飞
一𣂏龙井寒|未续茶经笔|林外忽闻香|僧房焙茶日
众芳各自媚|惟兰傲幽独|与世谁相知|奇石与古木
深谷煖云飞|重岩花发时|非因采樵者|那得外人知
惟不识泥土|堆根抱玉泉|虽离岩谷伴|也则翠千年
怅饮惜离群|穷边去路分|雪深山馆夜|孤雁背灯闻
椒涂承茂渥|嫔壶范柔仪|更以亲蚕茧|纫为续命丝
未开香已出|静者以心闻|日夕幽窗里|忘情赖有君
捲幔东溟阔|抛书晓月寒|松风便入梦|谁作怒涛看
刘项英雄志|争如溺爱何|宁无戚姬草|赖有大风歌
险语迫飞霆|将军惊落箸|明朝卖履人|泪洒西陵树
范侯渥洼种|出水已权奇|失身肉马群|俯首枯豆萁
幽花明曲栏|流莺在高树|解襟且衔杯|一扫俗尘去
解衣坐渔梁|水风来许许|月明不见人|幽篁自相语
腊月大堤边|春风思宛然|杨枝摇白日|烟花袅金鞭
深心探豪素|萧条无所欲|临池爱清风|坐荫数径竹
山腰一石窟|其深不可计|静听水潺湲|流作涧声细
岩洞何人道|仙凡此路分|不缘苔藓滑|石磴自流云
蒲牙长几何|已足庇玉尺|只恐如主人|潜逃逃不得
饭饱云岩粟|茶甘碧涧泉|我来无一事|危坐听山蝉
使君本人杰|挟策游蓬莱|朱颜映绿鬓|片诺雨花台
输赢每自如|万事亦何有|君且莫扬拳|输还酌吾酒
睡起当窗坐|远山侵竹斜|竹西官路口|一骑入林花
曲席纷罗绮|中腔度管丝|欢声连万井|一一拥春祺
兰草不知名|香含朝露清|花长休出叶|岁晏忌孤荣
遥望鸡鸣峰|神瀵涌如射|时听金鸡声|人间道天赦
竹根穿石嘴|松影入泉心|不致玄玄处|白云徒自深
平生不解愁|雨落听总好|此际雨声来|沈沈北邙草
我怪东风黠|暗知春欲归|尽将杨柳絮|剪作雪花飞
渔舟晚唱来|声在秋江水|月明曲未终|前汀鹭飞起
纵身尝决云|山月此晶皎|疑是七还丹|邠盼吐物表
执热宁忘濯|清心自释烦|东朝闻好语|畏日解馀暄
拔地千峰起|芙蓉插晓寒|当年看不足|今日复来看
茂树坐终日|水流心不竞|谁识山中居|万动归一静
绿房韬紫的|玉片踊重葩|公论评优劣|难私解语花
采阁闭朝寒|妆成拟问安|忽闻春雪下|唤婢卷帘看
欲歌春望词|谁是知音者|门口木兰舟|常系垂杨下
风漾钓丝轻|兰舟不碍行|一声长笛晚|江静月孤明
振衣望天汉|六翮来长风|翩翩佳公子|胡为浊世中
帘外燕交飞|天涯人未归|大儿新上学|白纻自裁衣
朝日惨无色|昏昏水气间|到淮犹数里|隔岸见尖山
秋冷骊龙卧|高垂颔下珠|紫驼银瓮里|遥想出天厨
风枝翻夜鹊|露井响秋虫|安知灌园者|不与汉阴同
西风吹石岐|鳞甲起深辙|借问去来人|谁是骑鲸客
仙人冰雪姿|贞秀绝伦拟|驿使讵知闻|寻香问烟水
老去唯耽酒|春来不著家|去年来校晚|不见洛阳花
款语途中绪|联镳雪里山|乡关何处是|回首泪痕斑
牛可理百亩|书能知经纶|耕罢究千古|阿衡果何人
相送寒潭上|船开更相望|人语隔江遥|微风自鸣浪
乌帽风前落|黄花雨后香|渊明三径里|明日共壶觞
金屑眼中翳|衣珠法上尘|已灵犹不重|佛祖为何人
山光分远近|云气异朝晡|过客俱能赋|开轩即是图
一夜春雷发|群蛰自相语|神龙岂不劳|人间要霖雨
权郎笔墨禅|往者屡参请|斯人骨已朽|妙处一笑领
并房金粟密|剪缬浅红光|莫把山丹看|临池夏日长
不见中书君|不闻老成人|为君作佳传|继者皆尖新
拔地山争秀|藏天谷受虚|云开西蜀后|木老避秦初
一朵风兰好|空生不作趺|自来根本异|宁待露沾濡
款段独行迟|揽辔亦自适|天清无片云|遥遥见山色
人不能外事|事不能外理|二障佛所言|吾儒宁有此
白云不作雨|作雨但霏微|长罨青山路|唯教翠湿衣
尔腹诚便便|何如边孝先|侏儒饱欲死|笑我非臞仙
日斜一局罢|观者谓机深|偶尔见敌手|由来无胜心
膝上横焦尾|何人识正音|汾亭空有操|不及杏坛吟
玉柄蟠蛟螭|隐见前朝字|逍遥七百言|花照瓦棺寺
彩胜镂新语|酥盘滴小诗|升平多乐事|应许外庭知
风轻杯荡漾|岸曲水逶迤|遇坎亦可喜|倒行羞接篱
望眼山连北|归心月向西|羁魂与别恨|愁杀五更鸡
杳杳河洲晚|客行殊未返|目随林鸟还|心共征鸿远
举世皆如梦|虚堂昼掩扉|几人名利窟|回首解忘机
献策黄金阙|之官岭外州|送君离恨少|江水共悠悠
柳花下阶砌|衣动香氤氲|蝴蝶不相识|亦来衣罗裙
百度看星月|千回望五更|自知无夜分|乞顾早天明
悲角奏梅花|江云冷万家|不知青女妒|却道弃铅华
老树叶似雨|浮岚翠欲流|西风驴背客|吟断野桥秋
自昔名高世|皆由艺入神|未应除扁鹊|世上便无人
天马谁能驭|和鸾驾紫微|年年清暑去|霹雳逐龙飞
暑雨润吟笺|薰风清绿绮|新蝉欺客愁|庭槐吟不止
自在疏林下|幽香满露丛|相依君子竹|叶叶是清风
园花满百种|种种足春光|百年春尽醉|才得九千场
中黄恋世乐|西域劳仙职|快哉吕子华|方台寄幽迹
宫商初不解|敢谓无知音|欲得林中趣|泠泠弦上心
贞姿抱冰雪|粲粲楚江滨|照水淡寒影|寄人生远春
紫裳苍玉佩|乞与碧纱笼|怕作行云去|人间瑞霭空
锦辔赤茸鞦|青骢间紫骝|倾城惊掣电|千里一回头
晓汲寒泉清|明月各在缶|缶空不见月|引水复在手
远屿孤烟起|林亭落日虚|青山半江影|竹里照残书
出语脍一世|不受儿辈悦|总为般若河|雅无文士筏
壮哉昌黎笔|谈笑排佛祸|不言动鬼神|翻疑触雷火
仙人扶绿玉|时亦铿然叩|振动三界中|烟霞一灵寿
玉河回宛转|丹阙对嶙峋|出入云霄上|蹉跎江海身
返照入高楼|楼中客惆怅|开楼看秋色|犹在阑干上
日落长亭晚|山门步障青|可怜无酒分|处处有旗亭
寒草才变枯|陈根已含绿|始知天地仁|谁道风霜酷
法师禅定时|万象付冥漠|至今岩前石|每每天花落
松下时调鹤|溪边日钓鱼|孤山林处士|封禅总无书
两峰高入云|特立竞萧爽|何当挟飞仙|遨游任来往
杨子谈玄宅|陶潜漉酒巾|一时俱寂寞|愁绝不堪论
柳以柔故重|枣以弱故惛|凛凛首阳人|何赖东皇君
水气含云白|山光吐雨青|帆低争拂树|过我浣花亭
早觅为龙去|江湖莫漫游|须知香饵下|触口是铦钩
游子转兰船|调侬曲港边|采花先得藕|不受外人莲
独乐园中客|朝朝常闭门|端居无一事|今日又黄昏
吾适点也志|暮春春服成|迟回绿柳下|载听黄鸟鸣
春风桃李蹊|学语鸟相唤|不可无寒芦|汀洲下凫雁
知音成死别|痛绝壁间琴|不尽西州感|衡门芳草深
鸦丛桑椹紫|蝶穴菜花黄|水鸭眠依石|竹鸡啼过墙
风光开户牖|松下日张筵|陋矣陈蕃榻|何须计万钱
一片泥滑滑|纵横荆棘树|月暗少人行|前村不知路
乔林动秋风|索索叶自语|堂堂侍郎公|高怀政如许
文殊驾狮子|普贤跨象王|新来一个佛|骑马也何妨
所借非佗物|能忘是此心|弦歌时一到|驻作武城音
难泯同胞好|每因长舌疏|若能谐妇姒|九世可同居
绛节徘徊引|天花散漫飞|高真无染著|片片不沾衣
真闲聊野服|至乐止人寰|肯为神仙误|虚寻度索山
黄河杳无际|白浪卷山回|不待穷源去|方知天上来
明月青松枝|幽人岩下步|劝君早归来|草头已多露
冥搜肠亦苦|只字得之难|作者有六义|惜哉坐一寒
偃蹇登修阪|高侵云日间|几人征戍客|跋马望家山
妥帖红云朵|迷离玉兔儿|扬州行乐地|惆怅鬓成丝
每虔夕惕心|妄意遵遗业|顾予不武资|何以成戎捷
燕麦摇晴日|青山两岸横|吴其为沼矣|倾酒任船行
夜分醉微醒|山楼半衔月|闺人犹未眠|月底看蚕叶
妾失鸳鸯伴|君方萍梗游|少年欢醉后|只恐苦相留
红英斗日开|暮落锦成堆|不藉西风力|孤根委草莱
东西耕钓窟|左右利名津|倚遍阑干曲|知几有几人
卮江海蛟□|□□母子悲|□□□□□|□□□征诗
长伴百花开|不共百花老|误却送春诗|只疑春正好
吴国初成阵|王家欲解围|拂巾双雉叫|飘瓦两鸳飞
我住浙江西|君去浙江东|日日心来往|不畏浙江风
夕阴下松间|虚馆春风里|夜窗灯火深|儿童弦诵喜
有美道乡孙|学道如学海|海水即吾泉|山下真源在
鱼行日千里|花落春三分|慎勿过溪去|矶头有钓纶
飞仙辞阜乡|玉舄留斯亭|所餐蒲九节|涧上至今青
我邑登贤载|君家父子俱|清风端一砚|五马达乡闾
坚轻筇竹杖|一枝有九节|寄与沃洲人|闲步青山月
秋荷一滴露|清夜坠玄天|将来玉盘上|不定始知圆
惊喜君王至|西华夜启扉|后车三十乘|载得美人归
叶似新蒲绿|身如乱锦缠|任君千度剥|意气自冲天
神龙泽一世|岂但三尺用|清潭知几许|吞八九云梦
金粟远飘香|霜枝寒吐萼|相将领素秋|不用悲摇落
同作金门客|相知今几年|花前曾对酒|醉和白云篇
地下多吾友|皆为殇鬼雄|夜来梦雪窦|长啸战场中
昭崖泫泉液|勃勃上云气|未遂朝宗愿|先有为霖意
合肥一都会|世号征战地|我来值明时|不识兵革事
孤鹤唳苍松|哀猿啸寒月|游子久未归|对景乡心切
池上藕花开|香从太极来|亭亭清净观|君子日徘徊
诗人善咏竹|琢磨故自修|猗欤睹威仪|千古谁能俦
春看洛城花|秋玩天津月|夏披嵩岑风|冬赏龙山雪
元帝何曾谕|京生自此疏|区区推卦气|欲撼石中书
春瓮𥬠新蚁|秋盆鲙锦鳞|高眠无一市|争羡市朝人
嵩脉来迢迢|鸡笼峰突起|不是烟霞心|貌来那得似
止水搅不动|好山邀辄来|松间寒月晚|似欠两翁催
天边登北楼|岁暮望南国|江梅与塞柳|莫问春消息
有景荣千𪩘|无私瑞九垓|水精排瓦砾|天库委琼瑰
小小红毛兔|冬肥及野鸡|连朝亲射得|跃马黑河西
飞去三千里|开过几劫春|此言谁解得|还汝日东人
霜月照人悄|迢迢夜未阑|鸳帏梦展转|珠泪向谁弹
春梦复春梦|梦好不知春|只有双蝴蝶|怜他梦里人
三周华不注|水影浸青天|不上银河去|空明击棹还
白骨苍烟晚|黄云塞草秋|貂蝉虽足贵|闻说出兜鍪
病愤无凭写|翻然试一来|谁知丘壑性|畴昔斗牛回
遵海忽南来|潮浪接紫荇|入夜梦寒光|虚寮涵素影
酒令军经略|诗旗愚树降|门前风雪大|更为尽馀缸
暂留同尔去|此语若无凭|好待莼丝熟|应逢张季鹰
伊昔芙蓉梦|于今花影连|情深看宿鹭|分我枕中天
虎落入长围|期门突似飞|乌号惊霹雳|白额藉忘归
大雅久不作|正声今在兹|虞廷赓歌日|山斗起遐思
江上采桑女|茅檐还是家|山花随结束|各自足生涯
睡起珊瑚枕|微风度屧廊|芙蓉最高叶|翻水洗鸳鸯
阁迥青林上|台孤碧雾悬|寂寥谁与晤|吟眺下江烟
水不经三峡|山犹过九盘|数家修竹里|堪入画图看
云海荡吾胸|笔随意所到|犹如剡上船|何必见安道
胜事荒湮久|高城观阁宜|均劳青琐客|馀事海山诗
呿口眼尾垂|欲喷将未发|竟以纸用事|快等船出闸
赠尔山龙锦|去谒广寒君|骋骋天河步|依依侍五云
云谷翠森森|冰霜阅岁深|已看能凤舞|还听作龙唫
终日江头坐|临流非羡鱼|狂澜嗟未倒|愁思竟何如
香使神清爽|先春为我开|微风吹不去|香自返魂来
凉雨蹴春波|曲曲随堤转|时泛桃花来|不知源近远
晚岫含残日|寒波荡远空|层栏人独倚|秋思渺无穷
一丛三百朵|细细拆浓檀|帘幕护花气|不知窗外寒
青林带平楚|杂坐惟渔樵|回看万峰里|一径入中条
未得吴公荐|空怜贾谊才|年年三月里|相忆看花来
落日荏平道|孤村未掩关|望中青隐隐|人说是陶山
得夜不韬藏|飞星乱草塘|都缘光影误|无路出书囊
桃结千年实|莲开十丈花|芦香并槿茂|应笑阿瞒家
停杯问明月|明月不能荅|相随下江潭|夜把苍龙踏
境胜日偏长|心清夏更凉|超然远览处|何止傲羲皇
湖天一叶舟|举网此生谋|几许风波恶|艰危不自由
闲随玉蝴蝶|步出花前去|不知春草生|忘却南园路
绿苞绽绀珠|红泉酝香屑|采采及清秋|汝南有真诀
小吏黄衣是|雄谭白马非|何如学方朔|割肉诙谐归
雨馀沙碛明|风起波纹乱|何处棹歌声|孤舟倚颓岸
昔贤云清音|不在丝与竹|何似奏钧天|夜半应空谷
理蔓牵新绿|疏泉放落红|敲门春午寂|有客夏黄公
驱牛耕侧坡|牛困人柰何|我念田家苦|东州苦更多
金杯阿刺吉|银筒速鲁麻|江楼日日醉|忘却在天涯
率怕人言谨|闲宜酒韵高|山林若无虑|名利不难逃
泉声日琮琤|泉水深浩渺|可爱主人心|亭中狎鸥鸟
孤臣遥浴日|沧海亦书云|愿得扶桑影|年年奉圣君
春信江南早|凄然念故乡|忽看纨扇影|转忆寿阳妆
峨峨太白峰|倚翠列霄岸|羡君乘兴归|凭栏与谁看
飞楼凌倒景|下照清彻底|时有步虚声|随风渡湖水
寻源路已尽|笑入白云间|不解乘轺客|那知有此山
舟移石头岸|路转马鞍矶|惟有长干塔|相看未忍违
逸少曾留玩|人因唤右军|鸟名加爵号|不离羽毛群
展画发古香|弄笔娱昼寂|是中亦何好|使我喜忘食
蓬上踏雪声|如行深木叶|惊起梦中人|忆得山上别
风送出山钟|云霞度水浅|欲知声尽处|鸟灭寥天远
天香浮玉露|金色艳高秋|谁似双栖者|相依共白头
巴山楼之东|秦岭楼之北|楼上捲帘时|满楼云一色
云来积金峰|影落朱阳馆|先生不出山|窗中共舒卷
入谷闻空答|溪深六月寒|松风三十里|常作九秋看
胜无良可慰|如幻亦何思|谁种伤心业|为渠出腹儿
浑如白帝峡|千里一朝还|独少阳台女|双蛾碧雾问
银杯侧西风|罗襦不禁冷|空江月落时|想象孤鸿影
中岁闻大道|炼已成蹉跎|去日一以多|来日今若何
若作如斯候|切在细推寻|如逢肾脉上|多应肠入阴
仙子来仙山|授君碧玉屑|更约三千年|去看桃花结
神物合雄雌|归来事太奇|精光犹未灭|会有报恩时
山水自空生|圣谛亦不二|溪声松风声|谁是第一义
今夜淮阳月|清光似故乡|有人千里外|对月望淮阳
江云载客愁|江色未分曙|君若回首时|莫忘别离处
邻多素心人|太朴求吾适|耕穫自有馀|似是柴桑客
叶暗辉辉度|孤明炯自知|月临光不掩|星乱影须疑
晴穫农人喜|安流舟子閒|平林戚墅铺|迥野浙西山
从古蓑笠翁|云水自怡悦|不是先生来|江皋虚夜月
不分光浮地|还函明镜奁|寒辉殊未灭|春色梦中兼
野客爱寒芳|经旬再举觞|名花不在色|美酒独宜香
何以问遗君|絓絓白玉䌷|绸缪千万丝|自妾心中抽
民归新邑去|古寺静寥寥|僧映水遮户|客随云过桥
东山月生光|照我庭中竹|道人发清啸|爱此茕茕独
众芳结为屏|左右映红药|问讯园中人|何如金孔雀
凉露滴空岩|蒲团阁初醉|呼童更煮茶|月落僧未睡
昨过瑶池上|霏霏雪有香|谁言金母好|白发已如霜
秤锤盘巨石|藏重亦藏轻|待出持衡手|一匡天下平
龙准高不高|虎颐短不短|半夜昆仑儿|两手扶银碗
何处觅消愁|春园可暂游|菊黄堪泛酒|梅红可插头
束发诵遗篇|生迟五十年|焚香端不愧|心迹可青天
珍禽解姓秦|弄语向芳春|购得从蛮女|边鸾画不真
千里来看竹|秋风欲动时|虚舟元不系|何问主人知
老以书为命|眼将书作雠|芗林与诚叟|同贩短檠愁
二月山容醒|林端别有香|心知春尚早|蜂蝶一齐忙
对酒无歌舞|看天只咏诗|唐贤文满案|半是乱离词
岁寒冰雪里|独见一枝来|不比凡桃李|春风无数开
已从三巴来|复向三巴去|借问行路难|猿啼子规语
迢递云山阻|庭花几度开|恼人双蛱蝶|飞去更飞来
扬州好明月|夜夜照高楼|咳唾风前落|笙歌月下游
雪中多日静|春富野人家|废苑荒堤外|谁知改岁华
沉香为马栈|翠羽为马房|马饮葡萄酒|旁多红粉妆
所事既非主|不归将若何|门前五株柳|空惹北风多
新声虽自知|旧宠会应移|无令枣下吹|便作一枯枝
水性本来弱|渐寒成此坚|东风有时到|几日是残年
草色依稀绿|花稍隐约红|一般难道说|如醉在心中
酒喜小杯饮|诗快大字书|不知人世上|此乐更谁如
江涨行无路|西风又打头|颇闻商妇怨|自作贾胡愁
双睛碧珠莹|四翅青罗薄|但知逐飞蚊|不复顾黄雀
行仁隆治道|偃武为生灵|恩施周遐迩|熙熙万国宁
不喜追风骠|尤憎竞渡船|宁为之反殿|怕著祖生先
塞北长寒地|由来□物华|不知羌笛里|何处得梅花
□瓮三杯酒|方床一觉眠|天涯万里客|如此过新年
久羡流觞事|重寻曲水湄|山灵应有约|岁岁好花时
玄云杳无迹|湾水尚漫漫|山月一何皎|流光溯急湍
短梢尘不染|密叶影低垂|忽起推篷看|潇湘过雨时
两驼侍雪立|终日饥不起|一觉沙日黄|肉屏那足拟
滕六雨天花|南枝香斗白|琼玉两模糊|冷笑从君索
青山寂无人|空陂澹流水|垂杨不胜春|摇摇蘸清泚
松柏何青青|下有将军墓|犹疑论功时|屏退独倚树
乌头疗白头|种药堪自足|日长陟高坞|心洗千挺玉
去岁中秋夕|维舟楚水滨|可怜今夜月|犹照异乡人
清林不知暑|一觉群鸡鸣|野圹气森飒|天空夜虚明
道大光今古|功成付圣明|超然群物表|但见四时行
枯荄没古基|駮藓蔽丰碑|向晚微风起|如闻坐啸时
燕南春色老|燕北草初肥|露冷野花瘦|月明江树稀
不是因三秀|名堂意自深|要居森戟地|毋忘采芝心
蜀道天下险|王尊叱其御|何况鸡鸣道|今随六龙度
九龙吐香水|兹事已千秋|道是本无垢|年年浴未休
昨蒙记云萍|得得睹台星|君宜厚自重|绝似前金陵
我诗虽云拙|心平声韵和|年来烦恼尽|古井无由波
橘里争棋叟|壶中卖药公|苏柑肥似瓠|盛不得樗翁
送君若浪水|叠叠愁思起|梦魂如月明|相送秋江里
感君刺臂恩|聊此休六翮|夜来警露声|时堕清音栅
驱马渡南涧|涧水清且驶|蹀躞未肯前|磊磊青石子
春晚独馀芳|风回带酒香|美人偏爱看|因似御衣裳
诗家在东皋|鸡林价争售|作者复几人|风月三千首
英英岩际云|相将庇幽独|肓风自震荡|慎勿憾我屋
群峰列如掌|传闻是九华|仙人不可见|千古閟烟霞
木落空山静|秋风肃羽毛|雄心思击搏|狐兔竟何逃
何年姓此渎|天设岂无因|五百年来我|题诗过暮津
造化栽培久|秋光逼草堂|天风无禁约|吹散广寒香
一足不能行|神仙宁此留|祇以形之似|高踪何处求
明月为我至|终夜与徘徊|犹恐双扉启|清光欲去来
一心聊自适|两膝报平安|烟艇南溟外|浮云细细看
胡羯宁知分|中原欲并驱|设兵生建武|堪与赤眉俱
空斋袅松竹|欲去更惆怅|何日是归期|南窗梅蕊放
偶逐微官去|暂掩林中宅|手种茱萸树|归时高几尺
劣女还闺合|痴爷看日头|几生亲骨肉|不共戴天雠
荡漾前溪水|萍开自不妨|蛟龙吞作雨|玄泽满天香
除却祖生外|馀皆在下风|老奴口耳小|安得肖司空
冰解初分窦|波平便泛舟|岸花红吊影|沙鸭绿昂头
禁殿安蚩尾|骚人逐毕方|何如栽此草|有火自能妨
杨柳垂千缕|风吹挂玉楼|美人怜不折|欲系紫骅骝
野径行无伴|僧房宿有期|涂山来去熟|唯是马蹄知
被发卧盘石|红颜朝日光|有鸾自歌舞|不嫁长沙王
向晚适幽兴|行吟下村路|前溪一抹烟|轻罩千行树
人来认海棠|却讶枝条弱|嫩蕊不胜春|生怕东风恶
藏六自为巢|巢莲岁久交|支床犹耐辱|曳尾敢辞嘲
夜气春融和|曙光晴皎洁|漠漠碧云端|斜露清霄月
虺蔓奋长须|累累明月珠|休传酿酒法|万一误分符
邺下然萁句|淮南布粟歌|相煎容不得|奈尔二人何
瘦容无住著|举手评来宾|不是无言说|虽穷不讳贫
古藤生洞口|不遣游人入|酌酒坐藤阴|飞泉忽相及
春晓慈闱启|君王奏问安|和声调嶰管|欢颂献椒盘
灯晦客无寐|床空夜不眠|凄凉心下事|月到小窗前
一岁两逢春|皇都景物新|发生何处早|甲拆验庄椿
自有此山扃|疑与浮世隔|清风袭我裳|竹下有来客
落寞经秋尽|蚕绵未着衣|酒狂诗欲发|已被菊花知
是谁挼蓝染|千条万条碧|我欲问东风|东风澹无迹
课馀自哦诗|诗罢还教子|时时视橐馀|质鬻市薪米
明农君早归|荣宦世多巧|呼鹰自贤豪|行歌饭牛饱
一梁对一柱|绰绰自横陈|谁拟复谁即|温然无故新
水落星滩口|风恬滟滪堆|乘槎皆估客|应载蜀山回
往岁桐江雨|今冬桂岭风|疏枝饶冷蕊|孤操见春容
如盘而柄圭|崇祼以为器|秬鬯次第陈|岂容忘古意
儿童娱膝下|母子话灯前|却忆江湖上|家书动隔年
莫问前朝事|但看江上台|平明拾翠去|薄暮踏歌回
梧叶落满地|西风洗九天|鹤声明月夜|曾此系吾船
戒饮长防病|停杯愁不禁|计量轻与重|愁比病还深
无花地亦香|有鹤松多直|向此奚必孤|山僧尽相识
夜月三杯色|晴荷十亩香|若教兴世念|不甚觉风凉
水远高于席|山青欲入船|鸬鹚漫自在|出没大湖天
横杖坐松下|看云起遥岑|惟应陶靖节|会得此时心
采芝堪疗饥|煮石亦可餐|怅望商山老|浩歌蜀道难
野色满庭户|昼凉清景佳|一双白练带|飞上石榴花
一雨日夜零|阶前草更青|西风忽萧飒|残月照空庭
常随山上下|忽限江南北|共是忘情人|何繇肯相忆
鸡声茅屋午|霭霭墟烟白|市散人亦稀|山空翠犹滴
一门三刺史|四代五尚书|他族未闻有|朕今止见胡
登临常患远|游览不能继|此景对门墙|箯舆日三四
行云都是梦|听雨甚于秋|㶁㶁盈阶水|时时一尺流
终秉循良笔|难逃俗吏媸|不知三考绩|课最竟何须
秋山草木落|樵夫日相寻|幽歌出空谷|金石有馀音
枕石云犹冷|看花日未斜|应疑金谷胜|不是石崇家
昨夜三更后|姮娥堕玉簪|冯夷不敢受|捧出碧波心
地坦容车马|城空绝戍楼|几家烟火在|风露冷松楸
数战数败北|宁非将略疏|收功一匕首|安用读兵书
关山一只雁|霄汉两三峰|借问门前水|依然万折东
寒瓜削成菹|入眼犹自绿|借问长安儿|此味还知不
昨夜君王来|守宫辞残血|欢至方识愁|玉阶盻春月
大树秋霜老|新亭落日孤|登临时极目|风景未应殊
山风吹女萝|细雨石上起|湿尽石边松|还作溪中水
芳草知谁种|缘阶已数丛|无心与时竞|何苦绿匆匆
月色幸自好|元无半点云|移床来一看|云月两昏昏
今朝捲帘坐|时见一花飞|不惜芳菲尽|春风稍稍稀
春雨蛟龙变|不妨苔藓侵|苍苍孤直者|空洞本无心
疏散永无事|不眠常夜分|月中松露滴|风引鹤同闻
真驭遗踪古|寒泉泻石清|养源人莫测|流润济苍生
五岳行踪僻|三山去路遐|何如北窗外|坐卧九莲花
丈夫怀慷慨|胆上涌波奔|只将三尺剑|决构一朱门
山人爱长生|辟谷亦云久|何以济朝饥|紫芝大如手
千里骅骝气|飞阳尺素中|可怜曹霸在|泪与汗花红
共绾同心结|那知有别离|对人争忍说|不敢画蛾眉
子美诗之圣|尧夫更别传|后来操翰者|二妙少能兼
岭路萦纡合|泉流诘曲通|田毛无岁旱|山课与耕同
百岁已逾半|知复几寒暑|此事当究观|勿共俗子语
独坐鸣虫起|秋怀已不胜|西风窗下度|木叶洒寒灯
逢人询往事|四纪未能忘|一掬伤心泪|无由到渭阳
畲客石为田|田肥宜石粪|英州石太多|燔石无人问
薰风酣绿树|午日思黄鹂|的的罗窗梦|西邻可得知
北巡寮采合|舟饯此江浔|晚别隔烟浦|犹闻横吹音
棹发江声急|烟深树影微|沙鸥如有识|来往傍船飞
昨夜东风多|花神莫之禦|玉立对幽人|十分尽情吐
空谷谁能问|幽芳独占春|不知湘水上|何处吊灵均
胜日游郊外|岚光入眼新|桃花开万树|又是一年人
散下渚田中|隐见菰蒲里|哀鸣自相应|欲作凌风起
东洛打空城|北邙连废阙|怀古动悲吟|远客生华发
秋浦绿层波|月明愁奈何|移船湘女庙|曾听竹枝歌
巫阳生绣户|春色满雕床|揉将花瓣碎|分得口脂香
春日洛阳陌|纷纷来往人|落花如有意|飞逐马蹄尘
修己师曾子|为人谋必忠|信诚交以道|传习熟加工
太羹有馀味|大乐无繁音|茅斋坐白日|冥契千古心
有美云堂树|冬生翠负霜|少阴精自固|名以冻青香
既历覆船冈|更嬉西岸圳|俛仰旧游心|光阴迅一瞬
江南季夏天|身热汗如泉|蚊蚋成雷泽|袈裟作水田
寒月出东岭|流光入浅廊|万心函片晌|一缕未消香
为脱田文难|常怀纪渻恩|欲知疏野态|霜晓叫荒村
蜀张与蜀花|乡人相解后|人存花更腴|人去花亦瘦
天寒关塞远|水落洲渚阔|已逐夕阳低|还向黄芦没
三峡连明月|九华多白云|伤心江上望|春树绿纷纷
幽兰有佳气|千载閟山阿|不出阿兰若|岂遭乾闼婆
独绕烟村来|共兹玩云月|细雨夜已阑|深意殊未歇
一朵朝来吐|闻香识是春|天将香所自|密与岁寒人
望月捲珠帘|窗风灭银烛|一榻下陈蕃|千秋见鲍叔
风光摇陇麦|日华映林蕊|春情重以伤|归念何由弭
天上和羹事|巢由不忍闻|疏花将瘦影|闲卧一溪云
六月凉风发|飘飘吹客槎|持竿向溟渤|挂断海门霞
四贤堂外月|颜色满空梁|千古贤宣慰|中心一瓣香
粲烂朝霞色|峰头幔作亭|长城一万里|天接太行青
夕宿犹疏雨|昕朝睹大明|重光符景贶|熙事庆升平
郡中卧病久|池上一来赊|榆柳飘枯叶|风雨倒横查
尚自畏四知|于亲岂忍欺|种蓝有助者|拔去不妨奇
涉江朝采莲|涉浦夕采兰|送欢三峡渡|忆妾六盘关
故国三千里|名禽十二红|白头供奉在|挥泪湿东风
东峰五十三|西峰四十八|同为百一峰|细细数奇拔
本是青春鸟|生来便唤翁|几多头白者|怀抱尚童蒙
天水浮金印|云山作画图|禅钟惊鹤梦|云影落昙芜
卧云云无心|听松松有韵|快哉耳目中|吾今亦同分
轮囷一片峰|宛如黑云吐|犹疑肤寸合|解作人间雨
山霁行尤喜|虽泥亦自前|不知吟思苦|忽到断桥边
隔水唤渔子|抛罾客上船|渡头人过尽|白鸟傍舟眠
云合虹腰断|风回两脚斜|浅滩屯宿鹭|高树竞栖鸦
珠藏泽自媚|玉蕴山含辉|凭君细调护|至宝人间希
琴尊虚槛里|独坐有高人|月映桐花夕|风归柳叶春
芦花秋水涨|不见客帆归|惟有云边雁|翩翩南向飞
谁种山中玉|空闻天上槎|只今尘似海|便拟竹为家
落叶随飞鸟|疏砧答暮蝉|悠悠戍楼角|凄切万家传
主人不相识|独坐对林泉|莫慢愁酤酒|怀中自有钱
东坡真天人|落笔蓬莱宫|何如赤壁笛|一鹤横秋风
气留脐可煖|唾使面自乾|无怨亦无恶|此腹如此宽
初学苦支离|闲心自得师|纤毫皆帝力|无语付天倪
古井无渊源|千秋自涵养|日暮汲人来|洞然发清响
秋风林下起|乱叶正纷纷|只可醉时看|不堪愁夜闻
潮来舴艋正|潮去舴艋攲|士生那无学|学则气习移
怀仙津步翳|凡圣隔两尘|长统植园果|老幼分甘珍
常恨闲行少|匆匆忽解鞍|秋风尹家宅|更得暂盘桓
五马俱何在|孤云得所哉|山光悦人面|丰胜未归来
春江风浪生|细雨多芳草|梦随归雁飞|片时千里道
真火本无候|时人休强猜|要知端的意|无去亦无来
野树花初发|空山独见时|踟蹰历阳道|乡思满南枝
拍岸鱼遗子|排檐燕引雏|有生俱有欲|情爱岂其无
千古慈云岭|诸方南北行|江波与湖水|极目两分明
山俗尚古野|五家同一村|何曾苦谢客|人自薄闲门
一掬终天恨|千年苦海深|蓼莪曾有句|宁了古人心
老夫饶白发|背立桃花树|寄书匡庐僧|春山共来去
寒风夜萧飒|门外白皑皑|窗破何须补|从他雪入来
被冷明光夜|兰香画省秋|清时闲法吏|吟倚白云楼
日暮西风起|吹侬两泪飞|那能如白露|一路洒郎衣
炯炯平生心|白日青天在|深山南斗高|无夜不再拜
垒石疑天造|飞来小赤城|阳乌出海后|如有彩霞生
密蕊与繁枝|参差间竹扉|红芳虽自媚|绿刺罥人衣
万里长江客|东风过裕溪|不知今夜月|何处听猿啼
观莲忆濂翁|因得风月趣|忽然光霁生|乃在过桥处
少年骑骏马|意气两相骄|驰骋春风里|人看满渭桥
缄蕊怯寒风|清香已暗通|数株篱落外|生毓任元功
一叶烟波艇|如乘银汉槎|秋来万里兴|浩荡属谁家
泬㵳银浦阔|缥缈客星高|却笑枚乘赋|空夸八月涛
细书妨老读|长簟惬昏眠|取簟且一息|抛书还少年
长羡空空如|虚空生冷籁|扫尽万顷烟|盈盈不下带
落日事搴陟|西南投一峰|诚知秋水浅|但怯无人踪
想归归未得|悔醉醉还频|不料湓江上|题诗送晚春
秋山枫叶赤|春水鳜鱼肥|独傍渔船去|沙头雁不飞
虚室昼生白|清风袭衣屦|圆蒲燕坐人|泠然欲仙去
我忆谷口孙|气貌清而腴|山潜三十年|吐此百卷书
问我家何在|山深多白云|岩前泉溜下|对语不相闻
山川秀而明|所居必名贤|主人虽凡骨|不慕衍客仙
野坐分苔席|山行绕菊丛|云衣惹不破|秋色望来空
玉路试新妆|盈盈照秋水|不是芙蓉花|颜色应相似
岭北荆榛路|城西浦溆深|白鸥时自下|知尔海翁心
山色和云暝|松阴间竹疏|隔岩啼鸟处|疑是子云居
碧草微茫处|江天欲暮时|想应农事隙|刍牧自相宜
长啸临高台|白虹贯四野|龙泉与太阿|汝乃知我者
小阁瞰清池|荷花镇长见|吏休苟得暇|只携书一卷
桂树及冬荣|瑶草待春发|唯闻鸾鹤声|寥寥上烟月
飘飘水中洲|杜若秋渐长|暗香洒寒流|时激清泠响
怪石胆瓶窟|从天倒插花|九阳一样泽|生意为何差
向晚菱歌起|风平水不流|鸳鸯两相逐|飞过采莲舟
地远隔亲面|惟凭一纸书|句终辄应诺|直是听于无
冬林覆草合|兀坐雪云停|避世栖金马|无人知岁星
寓此曾三夏|重来隔五年|溪山亦良是|怀想转凄然
楝叶迎新候|菖花发美祥|忧勤宣内则|嘉宴助时阳
散步至西园|草莽充庭际|稚子好为除|恐有草中蕙
酌水钵盂中|水味甘如醴|为有老龙蟠|山僧不敢洗
蕉叶何尝落|乾时可作书|绕庭三十树|人道绿天如
栋梁乃不取|得地且深植|妖娆紫薇花|岁晚犹伴直
蒲叶清浅水|杏花和暖风|地偏缘底绿|人老为谁红
绿藓深迎步|红霞烂满衣|洞天应不远|鸾鹤向人飞
数掩围柴荆|王维画不成|尤怜月中影|特地起诗情
南望越王台|千峰罨画开|分明团扇里|招得过江来
久洽烟霞赏|风花入讨论|龙声腾海外|徙倚独开樽
圜峰耸于前|鸣泉绕其背|若使画成图|谁云非傅会
江静月在水|山空秋满亭|自弹还自罢|初不要人听
点检春风事|瓶花最可怜|本根不知处|犹自向人妍
红润剥龟脚|黄香炙马鞍|山僧持净戒|同坐不同餐
映水俱知笑|成蹊竟不言|即今无自在|高下任渠攀
吭赤羽毛苍|华亭雪羞比|昂昂警露仙|翻作辽东豕
云山知几叠|山静云亦迟|道人衣带润|伸脚打眠时
悠悠转小棹|漾漾逐浮萍|载酒和嘉月|投篇吊独醒
千舆翠羽盖|万锜绿沈枪|定有葛陂种|不知何处藏
马嘶白日暮|剑鸣秋气来|我心浩无际|河上空徘徊
瑞雪飞琼瑶|梅花静相倚|独占三春魁|深涵太极理
复收旧鸾魄|来作新蝉耀|临妆人巳亡|倚面向谁照
白云已出岫|复此还山谷|幽人卧其间|常抱白云宿
结屋倚晴岚|移舟系夕潭|五湖烟水阔|只合老江南
佛郎通上国|万里进龙媒|晓日开阊阖|虹光射玉台
桥夜寂行舟|天影淡空水|独有无事僧|往来明月里
欲问庵中事|人驯虎亦驯|杨梅几番熟|谁为惜馀春
盥手天池水|熏毫海渚香|翻成多少帙|台石尚辉光
本买王猷宅|兼开蒋诩园|不须期二仲|好客但过门
诵经凌虚台|留骨希夷峡|何似学刘伶|未死先荷锸
菜叶阑干长|花开黄金细|直须咬到根|方识澹中味
花径宿烟霞|柴门来杖履|枳壳自春风|芭蕉又春雨
东西游走倦|家敝苦渊明|五子何须学|从他自耦耕
翠雨何曾湿|苍云本自低|湘山不可到|转觉望中迷
学尽百禽语|终无自己声|深山乔木底|缄口过平生
钿合收残黛|香风吹绿衣|闲来消永昼|非是效班姬
朝暾媚花木|户牖延荣光|新沐晞我发|悠然成坐忘
众响渐已寂|虫于佛面飞|半窗关夜雨|四壁挂僧衣
春去休惊晚|夏来还喜初|残芳虽有在|得似绿阴无
峥嵘十尺幽|谁辨白公留|试唤香山丈|时时解点头
横浦江南岸|梁家闻世贤|一株连理木|五月荔枝天
李枣栗银杏|橙梨柿木瓜|杨梅与金橘|不让满园花
浚极疑无底|丰棱定有因|沈沈中夜月|照影属何人
落落栋梁具|阴阴冰雪姿|曾经钜眼识|登用合乘时
溜亮语交交|闲枝且托巢|鹰鹯尚黄口|侧目在高梢
鸾凤不相待|白鱼困密网|但讶鹿皮翁|冥冥任所往
昨夜西窗雨|不知何树声|今朝团扇里|看得最分明
吾人真铁人|畴昔已百炼|携家过残年|来吃随堂饭
开轩向芙蓉|红绿如捧拥|游鱼定相忘|时见花光动
我有江南屋|春深草映门|湘帘低不捲|宝鼎夜常温
今闺久无主|罗袂坐生尘|愿作吹箫伴|同为骑凤人
谁种楼前荔|周天几岁星|子随心地赤|叶到岁寒心
近戍离金落|孤岑望火门|唯将知命意|潇洒向乾坤
寄语天涯客|轻寒底用愁|春风来不远|只在屋东头
洛浦风流雪|阳台朝暮云|闻琴不肯听|似妒卓文君
谁将一拳石|弃此湖水边|老梅盘拿春|玩弄到何年
镜好终双照|妆成覆绿纱|墙阴休洒泪|恐作断肠花
南园夷且旷|水木凝华清|天开景明淑|仰见昔人情
过雨琅玕润|凌风翡翠寒|何年沧海上|拾得断渔竿
避贤初罢相|乐圣且衔杯|为问门前客|今朝几个来
白发生今年|绿酒且今夕|每有忧生嗟|岂为勋业惜
白纻好裁衣|长短与身称|岂无旧所著|贵自故人赠
洛花肉红姿|蜀笔丹砂染|生绡多俗格|纸本有真艳
春日映朝霞|新妆出绛纱|开帘惊宿鸟|倚树落危花
烟霞变陂水|山照暖枫林|不听舟中语|谁知江上心
君许身比稷|视饥真己如|免吾学颜帖|乞米李大夫
楼近绩溪石|石镜明于镜|聚爱楼头人|照面照心性
道言有身患|佛说无生乐|问生何以尊|为汝解其缚
坡陀度小岭|轩豁见平湖|但醉梅花下|民家酒可沽
楚人菰米饭|越女芰荷衣|风土将相近|家园犹未归
履卑惧名高|居群忌行独|不见歌钟家|白日卧金谷
片片落花心|悠悠飞絮意|清风明月中|此风不可企
飞云流远浦|旭光荡风林|去住倏不滞|可拟达者心
搦管似有神|落笔惊风雨|岂是谢元晖|何如孔文举
汝母生邻死|安能向汝持|祇今衣裼在|空使血痕吹
新雨蕉叶大|云根生昼阴|只此可永日|何必弦鸣琴
山侣念别久|云芽寄荜门|竹下一烹啜|幽人时与言
谁道梅花早|残年岂是春|何如艳风日|独自占芳辰
小犬吠林颠|莺啼曲槛前|山深人少到|日拥野云眠
东林金马寺|南亭金马关|往来皆马客|试问谁者贤
桃花随意红|柳枝向人绿|山人夜归来|独上兰皋宿
月宇开天镜|高楼试晚妆|秋风吹桂树|双燕语雕梁
清源财赋窟|但富商与贾|笙歌满画船|谁识运丁苦
一疾缘医误|孤踪住世慵|泪痕添沫水|名字见峨峰
生死归殊俗|君王命妾来|莫令青冢草|生近李陵台
寻常忘物我|浑不涉希夷|梦落秋坛冷|从教斗柄移
玉蕊琅玕树|天香知意薰|露寒清透骨|风定远含芬
洒洒琅玕枝|既洗愈秀雅|莫作风雨声|有客南窗下
恨题玄都观|欢入武陵溪|花面无今古|人心自笑啼
百战方夷项|三章且代秦|功归萧相国|气尽戚夫人
折为督邮腰|悬作山人室|殊非濮上音|信是泗滨石
霜菊尤宜晚|才开一两葩|不随蒲柳变|索性待梅花
士女匆匆散|溪山寂寂然|龙舟闲似我|阁起向沙边
忽得三巴信|郎归未有期|只言风浪险|不是薄情儿
粤客龙须席|吴娘鸭嘴船|一声兰桨发|惊起月中眠
尘中不可居|何似远游好|便欲凌风飞|乘秋拾朱草
月明阶悄悄|影只腰身小|谁是鶱翔人|愿为比翼鸟
倚崖坐孤石|北对五老峰|中有千尺虹|挂断岩上松
帘帏照明雪|美人起常早|行看玉阶上|一夜长瑶草
曲径馀榛路|穹碑剥藓痕|空廊僧不住|邻媪为开门
镜悲鸾独舞|射感雉双飞|早认色空是|晚知婚宦非
密幄千重碧|疏巾一拶红|花时随早晚|不必嫁春风
相见能几时|相思复万里|愿作南浦云|随君度江水
天坠白玉簪|矗作君家林|忽尔天籁发|珊瑚环佩音
自嫁单于国|长衔汉掖悲|容颜日憔悴|有甚画图时
老树冰霜晚|孤花天地心|翛然怀远韵|相对意弥深
夜雨生白发|怆然青灯语|日出愁更深|应知不关雨
老鹤爱云栖|石洞自天凿|秋风时一声|飞云散寥廓
皎皎冰玉姿|挺挺苍翠质|精白一寸心|常捧中天日
浪说三遗矢|犹堪一据鞍|君王不自试|耳目信人难
芳原晴睇望|隐隐见荒林|鸟向青田去|云还碧涧阴
至今千丈松|犹伴数岩雪|不见纤尘飞|寒泉皓明月
香来著吾怀|先想纤纤手|果遇赠香人|经年何恨久
艺兰北涧侧|涧曲风纡馀|愿言植根固|芬芳长慰予
多求待心足|未足旋倾覆|明知贪者心|求荣不求辱
董氏娇娆性|多为窈窕名|人随秋月落|韵入捣衣声
尊嫜有严命|妾不获从夫|去去犹回首|谆谆别小姑
斜日清源北|浮云岱岳东|故山归路好|不得与君同
偃蹇复何为|把经倚庭树|忽惊山鸟喧|登楼看秋雨
今日寻此梅|危行石涧东|花神欲宣令|万铎悬春风
我琴未弦时|浑然心与耳|自从识开指|反为琴所使
拂儿虽草创|日用最相亲|莫遣维摩室|潜生庾亮尘
一自饭胡麻|仙踪隔彩霞|空馀双涧水|流出碧桃花
文犀无处觅|金锁已尘寰|满目沧江迥|渔舟自往还
浮云看世事|如水见交情|此道令人弃|悠然想太羹
秋风雪月天|花竹鹤云烟|诗酒春池雨|山僧道柳泉
路缘清涧转|门对白云闲|每每看图画|令人忆故山
春雨欲晴时|山光弄烟翠|林间有高人|笑语落天外
结庵已忘情|植竹更端操|迢遥月上床|习静谁能造
深浅生涯足|浮沉世念轻|莫贪钩上饵|去作鼎中羹
昼永卷书困|时闲挈杖清|草虫空踯躅|巢燕费经营
密叶秋逾润|幽花晚更妍|去来谁是主|试问白头禅
二月江南道|关关春鸟啼|欲知游子梦|芳草白云萋
弭棹月三更|秋砧断复续|听砧了不愁|翻理无愁曲
谁道林莺老|金衣薄更新|春来复春去|老却听莺人
苍髯拂翠羽|有意伴臞仙|共结岁寒约|村烟望水边
戢戢红葩静|亭亭翠幄深|可希金玉誉|恨是未虚心
素面倚栏钩|娇声出外头|若非是织女|何得问牵牛
此日故乡酒|应怜千里违|是处萋萋草|王孙归不归
樛枝卧龙蛇|冷蕊缀冰雪|千里故人心|今年为谁折
物理窥开后|人情照破时|能将一个字|善解百年迷
岁晚风号寒|琅玕半吹折|虽残栖凤枝|终抱凌霄节
晓色桃蒸霞|春阴柳垂雾|为问桥下船|沿流到何处
步屧越台上|诛茆越台下|越王复何在|松风自潇洒
泥沙埋自昔|嘉号得今传|未试真风韵|那知启自天
寒潭明似镜|秋半净于扫|携酒荡兰桡|月出林端早
天寒好风日|清香透窗纱|谁知蜜脾底|有此返魂花
远逐风尘路|遗书满目愁|思君不成寐|月上看牵牛
人皆知道德|性命岂精详|今知孔孟外|别自有主张
白发贫江南|青衫老江北|井渫人不食|伊谁为凄恻
江南仲春天|细雨色如烟|丝为武昌柳|布作石门泉
青帝留行迹|岩前春不归|尽从霜与雪|君看碧依依
灵剑经年匣|决云谁为高|报人如有道|何忍问吹毛
花摇知白鹭|水落见红螺|一片萧疏雨|声先到芰荷
含情辞汉宫|一去天万里|欲写琵琶词|无由献天子
我托南车去|君挐北辔还|相看一梦里|好入画图间
千山鸟飞绝|万径人踪灭|孤舟蓑笠翁|独钓寒江雪
动静贵一如|妙处非块坐|高人定不死|枕此白云卧
园果垂丹实|园丁日夜看|未曾供寝庙|不敢献中官
欲待此君醉|窃分凤尾馀|他年杀青手|高节为君书
自知身是患|常谓道无名|欲作闲中友|随缘论养生
人争汉口渡|日落阳台坂|鼓吹隔岸闻|楼观排云见
田中多峭石|苍玉乱攲斜|怪似湘中见|封域近长沙
独鸟下高树|遥知吴苑园|凄凉千古事|日暮倚阊门
远师不染性|持此遗陶公|三径虽云好|了知色是空
我爱通羊好|宗英迥出尘|文章与政事|今复见何人
国破山河在|宫庭荆棘春|衣冠今左衽|忍作北朝臣
掩关麾俗子|裂网禁畦丁|台下鱼相贺|溪边人独醒
鱼乐吾亦乐|其如网罟频|渊深饵不取|百尺虚垂纶
白发悲心事|青阳逼岁除|江城回客枕|寒漏四更馀
积雪连旬晦|江空岁晏时|客途偏感慨|忍诵蓼莪诗
与月隔一簟|去天争半篷|若无篷与簟|身在大虚中
园中有奇货|雨满瓜芋田|一饱吾已足|望山思悠然
岁去归何处|灯来伴此身|分明无事夜|也作不眠人
压枝高下锦|攒蕊浅深霞|叠彩晞阳媚|鲜葩照露斜
悄悄禁门闭|夜深无月明|西窗独暗坐|满耳新蛩声
荷芰藕生莲|每忆心中苦|拟掇断根苗|丝结千千缕
古墓石棱棱|寒云晚景凝|空悲虎溪月|不见雁门僧
得一万事毕|一居何所安|更能忘却一|即此是金丹
花蛇及干蝎|亦疗脑旋风|乌头勿单使|麻黄更要芎
暝色兼荒远|初分浦淑烟|应知汉江佩|月竹斗娟娟
峭节虚容物|清标直中绳|杖有削圆厄|提携先模棱
翩翩凌波仙|静挹君子德|平生出处同|相知不易得
并与杞同赋|旧尝闻雪堂|先生澹无欲|亦复爱清香
母德思齐盛|天心奋豫初|青晖凝辇路|佳气拥宸居
不种忘忧花|但栽怀梦草|梦长在君傍|何惜忧终老
畎亩心常白|江湖眼尚青|悠悠今古路|一一短长亭
原非人力建|造化琢磨成|一枕游仙梦|蟾波白昼生
支机何代石|风截秋云根|一叶下人境|坐令台榭尊
处处逢头路|头头是故乡|本来成现事|何必更思量
有客秋到山|山高月色大|持赠明府行|相随到呈迈
何处寻春信|江南路渺漫|夜深山月白|疏影隔窗看
恩酬期必报|岂是辄轻生|神剑冲霄去|谁为平不平
手持黄竹竿|独钓烟江浦|夜来不醉归|买蓑为秋雨
一艇烟波里|垂钩傍月亲|风尘回首地|多少未归人
野阔早霜明|林空凉吹动|一犬吠人来|松窗破秋梦
绚丽繁霞彩|荧煌瑞锦堆|夜深疑睡去|日暖怕慵来
白鹿仙车去|无人猎古台|空馀烟峤月|曾照越王来
山雄云气深|树老风霜劲|下有考槃人|超摇得真性
清飙动萧瑟|翠樾减婆娑|却爱夜来月|满窗寒影多
黄昏雨气浓|喜色满南亩|谁知一夜风|吹放门前柳
我爱山中住|山中秋复春|白云长罨户|来往断无人
举国听桓子|呼天诔孔丘|可怜倚楹女|徒为鲁君忧
寒飙荡月华|桂树渐无叶|一叶落人间|变作阶前荚
许负往昔矣|天纲今何之|谁知千载后|复遇林君奇
海日忽沉沉|云含雨气阴|通天一道水|吹作瀑花侵
旭日明春涛|晨风发清扇|瞥尔吕梁洪|飞湍去如箭
夏热秋逾甚|寒梅暑亦开|无尘管城子|幻出雪枝来
何以高吾枕|北窗扬晚飔|莫将周蝶辨|虚拟上皇时
人为天地心|体焉天地同|病于有我私|不能相流通
水花分堑弱|山木抱云稠|更宿招提境|还同惠远游
摘玉毁珠玑|蒙庄有深旨|向郭不能传|千载付吾子
局上闲争战|人间任是非|空教采樵客|柯烂不知归
扫地夕阴满|把杯江月生|绿蕉三五叶|先已著秋声
月出大江白|山近高城青|我归掩蓬荜|君去逐浮萍
轻薄如蝉翼|择兮风未休|烦劳汝威重|镇压彼轻浮
狙裹周公服|优蒙孙叔冠|无论𫘤儿女|神亦被渠瞒
寒云栖短柳|疏雨洒平芜|不见旧诗客|空怜水满湖
科头不出门|岁月已忘记|燕含花片来|知是春归去
乐奏天恩满|杯来秋兴高|更蒙萧相国|对席饮醇醪
美人汲深井|夜久井泉冷|独向明月中|徘徊顾秋影
疳疮生眼畔|疳血化为虫|即渐侵于脑|和睛变作脓
意气争官河|赳赳轻乃公|恒有脱死士|藏活为船佣
矫劲神偏古|孤高韵自清|终令众恶草|不敢傍根生
记得南园路|垂垂一树春|不知风雪里|还有弄珠人
白石洞间路|吾家在其中|琴窗与书阁|一半是云封
鸿雁隔春水|鹡鸰宿浅沙|翻飞共迟暮|终尔栖云霞
四壁人声绝|榻下蚊烟灭|可怜翠微翁|一夜敲打拍
片水涵烟岛|三山在屐前|秦皇何太苦|驾石倩神鞭
碧虹跨平湖|远岫参差映|门影入波圆|五十三明镜
凉天挂新月|寒竹影萧萧|幽人正无寐|桐叶响终宵
兀坐掩房栊|捧心讵娇态|闻说金张儿|懒出堂前拜
断鸿嘶极浦|远笛破寒烟|独夜三江客|归帆八月天
倾心曾向日|在手幸摇风|羡尔逢提握|知名自谢公
寄声谢轩帝|不必奏钧天|一碧九万里|横吹铁笛眠
峭壁空翠湿|幽林烟霏清|峰巅忽长啸|疑是孙登声
水石成芳岛|云林蔼暮晴|波光涵万景|不必问蓬瀛
云起有真意|水穷无尽心|盘洲宁涸泽|天下要甘霖
柳暗春风远|花飞香梦残|夜深明月度|寂寞玉雕阑
愚者昧其觉|贪生还一梦|不见餐霞人|唯见古时洞
白石映青苔|百丈深见底|临流问楚客|何似新安水
昔人怀故主|季世绝贫交|汝胜炎凉者|年年归旧巢
素艳羞妆额|红膏妒雪肤|宁临白刃死|不受赤眉污
汉使楼船出|三山隔海波|灵槎不识路|还解到天河
情知故旧长|话觉寒宵短|何如𧏖珠连|未许茧丝断
虹截江雨收|龙驱岭云散|渔屋起炊烟|舟人日晡饭
霞佩缀仙班|春风拥髻鬟|应无世间梦|怅望碧溪湾
失意穿罗袖|缘情恋绣床|妒遗衣上粉|狂觅酒边香
百中巧争能|一呼眦欲裂|眼底无秋毫|空中有毛血
关晚牛羊下|城高鼓角清|道傍迎候吏|马首拜诸生
高谢三公府|来耕五亩园|园中有何好|老子笑无言
流水小桥西|东风路欲迷|渔郎莫回首|不是武陵溪
山人水竹居|画图看更好|十年不归来|茅屋秋风老
跂跂有足蛇|脉脉无角龙|为虎君勿笑|食尽虿尾虫
孤根春意动|忽放八九花|莫将稀疏看|清香浩无涯
久雨闭园扉|未识春深浅|啼鸟破微晴|茸茸草如剪
秋高山气佳|木落江水静|意固不在鱼|鱼惊钓丝影
山中多药苗|往往发香气|不知采药人|曾嗅此香未
出山逢老人|入山化黄石|千载石人前|纷纷拜行客
西戍夕阳晴|东城石镜明|有山名八字|供作两眉横
老马宁为驹|即且或甘带|名迹吾不嫌|全生聊远害
雪埋凤林寺|浪打鹿门山|今日江风恶|郎船劝不还
灵地无纤翳|洁庵无点尘|琼蟾圆皎皎|光透九天明
池水欲成墨|古碑临罢时|闲从崖石上|风雨挟蛟螭
风转万年枝|冰开百子池|多男应禖祀|瑞气恰来时
霜鼓四更转|冰轮三丈悬|冲寒又上道|忆杀画船眠
便欲开船去|因君更写蕉|要知相忆地|叶上雨潇潇
警雁避罗舠|江长起未高|眼𢬵一饷后|看到入云梢
谤言三至后|直道叹何如|今日蓝溪水|无人不夜鱼
造化抟清气|秀出天城山|青松伴僧老|白云如我闲
落日船头浪|春风江上山|家园几千里|却向梦中还
寄语采莲伴|谁知莲苦心|齐桡翻弄曲|若个是知音
欲与梅为友|常忧不称渠|从今断火食|饮水读仙书
人道时苗事|怀廉不近情|犹胜尸素去|行李属归程
万山围欲合|一水去仍遥|不识方干宅|桃花满路飘
罗幌寂无人|玉阶秋草绿|永夜不成眠|飞萤照华屋
亭上可率饮|林间宜率吟|每于诗酒里|寓我率然心
劳鲂莲渚内|汗马火旗间|平生血诚尽|不独左轮殷
辈行有后先|志节无今古|君看锦绷儿|楚楚已可数
十年归旧隐|不听蚤朝啼|却向蓬蒿里|昂藏对竹栖
一蹶陨平芜|神灵为汝道|下有思子人|上有伤心草
目极江天远|秋霜下白苹|可怜南去雁|不为倚楼人
夫君活国手|爱此隐仙字|行再出刀圭|可使民久视
妾心如石坚|望朝复望夕|夫归傥不信|全身化为石
青山明夕阳|白鹭立秋水|忽闻渔笛吹|令人思无已
一雨众山绿|姚江春水生|云林回首处|方觉去舟轻
南风吹我襟|独坐邀明月|心事寄朱弦|可对青天说
窈窕东北峰|到眼佳有馀|行人日攀缘|岂知供我娱
千里及归鸿|半天河影东|家人森户外|笑拥白头翁
官失学四夷|寂寥洙泗滨|至此每再拜|西方有圣人
海上游梅福|吴门更不归|仙源流夜壑|何处有花飞
吴越争雄日|区区在用兵|空馀争战地|无处不高城
三步五步廊|千株万株雪|阿大故濯濯|与雪斗清绝
郁郁烈洲树|宛然江水间|行人自不上|妒杀道金山
平台依渌水|喧静称垂纶|祇恐非熊兆|江湖异富春
朝来送归客|复此长河湄|立马折杨柳|已无前日枝
绿橘阴虽改|青山色自新|偷闲时挟册|来访读书人
颢气自澄穆|碧波还荡漾|应有凌风人|吹笛君山上
映水一枝开|春从笔底来|高楼漫吹笛|终不点苍苔
月届今宵望|圆殊昨夜看|澄湖秋万顷|涌出紫金槃
奋迅鸣沙碛|欢娱佐玉堂|阅音思魏武|解秽笑明皇
右军墨池月|照我复照谁|千里忽相到|中峰多病师
望乡白云中|家本白云下|白云何当来|化为千里马
爆竹烧残岁|家家把一杯|西湖元自好|只是欠徘徊
渊澄如止水|泉活有馀波|梅到清香处|君应风味多
佳人天一方|岁暮音书绝|一枝持赠君|犹带去年雪
五王同帐日|花萼正辉光|一自玉环入|齿寒唇亦亡
五色曾呈瑞|绿毛从古稀|碧潭凝染色|逐藻长毛衣
久不陟岩扃|秋光宛如昨|白云满地流|忽听松子落
知音惭李令|问我复何为|道义惟添睡|功名只有诗
近者虽似小|远望却成高|要知深有力|腹上逆生毛
野眺旷无际|泼空云万重|无心闲点染|港口出渔翁
水阔秋光变|乡心在客船|高楼见红柚|诗意写樊川
坚轻筇竹杖|一杖有九节|寄语朔州僧|闲步秋山月
日永三星正|风薰万宇凉|要知垂艾意|期与庶民康
朝醉长安花|夕醉襄阳月|至今花月间|不见醒时节
扰扰复扰扰|浮尘飞不了|回首望京华|云边过一鸟
欲识古人趣|当玩古人心|古人既自得|视古犹视今
神龙生九子|谁道不成龙|灵泉本在田|为雨疑乘风
荧荧枯蚌中|急雪洒不灭|西风明日晴|双花为侬结
后皇权植物|奴婢遍江干|绣蹙一林橘|高擎黄玉团
洪江通海潮|朝往复暮来|岊水下洪江|何时逐潮回
清晨策蹇驴|正见梅花发|独往灞陵桥|千峰乱飞雪
江上春潮静|舟中日似年|不须生羽翼|无事即神仙
穴土谁为洞|温凉欲自私|人间有寒暑|坐此岂容知
丛生山上下|影在月中央|受性老弥辣|开花晚更香
倚竹候秋声|闲苔伫明月|时闻宿鸟惊|微风动林樾
短桥流不去|回波相激鸣|度我幽寻屐|千花隔岸明
涪山信有灵|送客六月雨|晓行如深秋|午憩无点暑
平接上峰去|忽从林莽颓|奇情供一径|并送此中来
按拍坐君侧|珍珠一线长|歌喉本鹦鹉|赢得作鸳鸯
抱叶微沾露|临风响遏云|偶然鸣木末|非欲使人闻
阿堵本何物|贯朽殊堪羞|空囊留得一|千古钦清流
嫩叶生初茂|残花少更鲜|结根龙藏侧|故欲并青莲
磊落终休矣|艰难晚见之|罔知当世事|殊悔少年时
对舞鸣仍和|双飞去复回|归家千载远|丹灶付苍苔
寒溜浸幽壑|危亭点翠微|忽惊双鹤唳|有客款荆扉
兰吐宜清夜|香惟风露知|露华多在蕊|风势不成枝
秋日更可畏|所宜惟暴书|反身还自笑|均是蠹书鱼
少女拜新月|临阶幽意多|但祈夫婿贵|不愿似嫦娥
山上白云深|云中出飞瀑|回看不见源|疑从天上落
玲珑白玉斝|置在翡翠盘|清池明月夜|怪尔生秋寒
时止则须止|时行则可行|时行与时止|人力莫经营
矗矗万琅玕|风枝带露寒|何当傍金阙|天子御楼看
冷馀红浪破|消尽紫沉烟|正是愁无托|杨花忽满川
片影云边没|孤声月下微|云霄千万里|何似故巢归
寺甲于江左|身迎入禁中|如何净居殿|饿杀老萧公
忆昨登临日|卿云正四翔|重来穷目力|天末起祥光
独坐倚山阁|山深树影重|客心何所寄|云外两三峰
言笑不可觅|暗风吹庭隅|开门见萝月|恍惚照髭须
古苔矶上立|钓为月明垂|夜半清歌起|无鱼钓得诗
柳墙高于花|怒飞方可至|奇哉游夏徒|吐辞作雄翅
柳桥通窈窕|客辔按玲珑|蒲剑一溪绿|酒花双颊红
一囊置我琴|一囊置我笛|明月照寒江|扁舟吊采石
濯锦江头树|移根药砌中|只应春有意|偏与半妆红
郴阳古名邦|四座拱山色|秀气钟异人|阛阓俨仙宅
寄书向知己|不解作家音|男儿铁石志|总是报君心
谁言府中居|自得山中乐|独醉还自醒|无人事酬酢
遗殿空长闭|乘鸾自不回|至今荒草上|寥落旧花开
落叶频惊鹿|连峰欲映雕|此生诗病苦|此病更萧条
朝朝一味豆|对对几缸兰|风动香逾远|不禁人倚栏
春水绿迢迢|空江自落潮|桥头两竿日|烟外酒旗飘
浪道渔家乐|供输亦未闲|君欲长安稳|隐于徒隶间
众评白傅谥|谁得乐天心|小太宗英主|临朝谥醉吟
天畔数声钟|听之清思发|独起步空阶|但见空山月
天时不可齐|天心不可违|君子能知天|手转丰凶机
贱宜人弗齿|贫遣日劳心|不著新诗句|春愁那可禁
山涧雨初收|涓涓水乱流|树根一片石|童子坐牵牛
野航谁谓小|恰受野人身|载我欲何向|五湖烟水滨
藜杖同僧扣|应门野叟闲|放他猿摘果|莫把白云关
林日不到地|溪风常满船|雨馀黄犊健|天际白鸥眠
乾坤有精物|至宝无文章|雕琢为世器|真性一朝伤
江县春光早|红梅却放迟|是谁枯彩笔|写得向阳枝
不作风波民|已铸赫胥印|同好岂无人|望崖行少进
边书犹插羽|世用在持矛|空言客何务|问事其少休
深林四无人|徙倚白云坐|山风日暮来|吹我鹖冠堕
苍云何处飞|白雪一以快|君莫问竹林|兰亭幸犹在
天下梅花主|扶桑文字祖|这个正法眼|云门答道普
曾无千岁人|安见千岁实|聊效昔所投|琼瑶报非一
携妓东山去|春光半道催|遥看若桃李|双入镜中开
珠箔上银钩|春花压翠楼|笙歌何处响|鹦鹉对人愁
倚棹春江上|横舟石岸前|山瞑行人断|迢迢独泛仙
一与刘园别|春风到海隅|墙阴草争绿|留得屐痕无
迟迟晓履移|欲去犹返顾|了了知心人|一笑隔烟雾
种麦不种芝|芝生在中阿|至今芟麦人|兼唱采芝歌
秋香五株桂|谢氏还几株|要识乾坤中|鲁国今一儒
芳草递春风|三山立桂丛|柳条随驾绿|花蕊上林红
春前一寸雪|春后一犁金|万里烟瘴息|九农和气深
举善甲期会|凿城计户口|所在置沼池|积水良可久
茅屋临溪口|小舟䌫初解|月上渔灯黑|溪翁方捕蟹
客心同日月|昼夜转双丸|那禁云山里|江流更几盘
月下弹瑶瑟|花前弄玉箫|宫沟水清浅|信是不通潮
决去先生勇|怀安二子惭|向令犹在坐|楚市赭衣三
小水通大河|山深鸟宿多|主人看客好|曲路亦相过
荒凉野店绝|迢遰人烟远|苍苍古木中|多是隋家苑
谁谓籊籊竿|乃不如劲草|北风动地来|直节未易倒
娇态殿馀春|芳名艳花谱|樽酒暖风前|僛僛为君舞
天外五峰攒|盈盈袅翠鬟|长风吹海树|指点认家山
箨脱始犹青|粉滋旋变紫|斩伐不须加|森然自堪倚
春风双眼开|落日孤帆去|相对默无言|悠悠渺云树
道不远于人|乾坤只在身|谁能天地外|别去觅乾坤
四出花中异|三开格外芳|名高评月品|韵胜霸秋香
谢客怜高会|西池春草生|谁知深洞里|还共听新莺
何处观朝阳|日日天东极|吾人孤凤鸣|长向朝阳立
阴生为月窟|阳生乃天根|阴阳互相长|天地寂无言
帆开建业水|人上豫章台|许令蛟腥起|滕王雨色来
平生独爱山|日日频跻攀|自得山中趣|结庐万山间
万山飞不出|有屈向谁伸|寄语弦歌宰|留心且为民
君归一水遥|魂断木兰桡|赖有南轩竹|清风慰寂寥
独鸟怨遥夜|冷萤明远陂|且弄碧萝月|莫问出山期
苍根封古苔|空腹餐冻雪|老意暗生香|丁宁勿轻折
江都全盛日|锦缆引龙舟|画楫三千女|空馀邗水流
完得一局棋|除此一袭衣|何去何来兮|白云共依稀
独舞依磐石|群飞动轻浪|奋迅碧沙前|长怀白云上
峰高觉涧深|山转疑路绝|村远投宿迟|松梢挂新月
雾鬣如无笔|霜蹄不带埃|直言明眼著|若个是龙媒
长日开闲境|春风美鼻雷|黄䌷依旧暖|牙鼓莫相催
为余三月住|寄食赞公房|却问香积饭|何如太乙粮
昔闻云中仙|遁迹人间世|青松将十围|苍鹿亦千岁
麦畦微雨过|日照青湿湿|牧童坐短蓑|牛卧寒鸦立
有人抱幽真|偏适林野趣|要之等喧寂|乃是安心处
栏外见春迟|朝来雪一枝|不知初发处|误道已残时
晨兴坐兹谈|而亦坐兹食|为言同寓子|尚念埴者力
夜思经世务|神倦方熟眠|晨朝气清爽|良心还烱然
湖上烟花暝|湖中丝管催|木兰双桨在|何处莫愁来
壁上烟森森|道旁石齿齿|举头不见人|但见前人履
蝉性极清高|愁吟类楚骚|炎天风露薄|度日亦嗷嗷
百年嗟荏苒|千里痛萧条|忍逐东流水|无期任所飘
篱菊抱香死|化入岁寒枝|依然色尚黄|雪中开更奇
母老儿亦老|何幸得生全|故乡有敝庐|菽水尽馀欢
渔师来卖鱼|船小风荡漾|得钱瞥波去|不怕江流涨
叔慎骑乌马|僧伽把漆弓|唤取长安令|共猎北山熊
两椅熨秋竹|一帘捲霜藤|山风长夜寒|兀兀挑青灯
附渚依汀者|丝纶掌握中|共悲名利客|故醉武陵中
重锦褰妆幕|轻罗换舞衣|钗头双燕子|先向社前飞
脱帻吏休后|凭轩风快馀|瀑泉增濑急|新叶补林疏
先人旧所理|汾曲有田庐|何意求闻达|弹琴自著书
促路蜉蝣短|雄心日月长|玉床飘穗帐|犹自恋余香
索文僧送纸|赌酒客争棋|定要全无事|何由更有诗
雪学嵯峨山|山似霮䨴云|云山何以辨|云白山色青
读易苦解事|阅世涕横臆|如何中天日|未见群阴息
急涧无停流|行云那得定|不息奔竞心|山林亦非静
烂醉君莫辞|宁忘前日事|瓶罄罍复空|开窗读老子
冰溪时咽绝|风枥方轩举|此处不断肠|定知无断处
饮马月明里|晓窗闻洞箫|夜深人不见|竹露滴芭蕉
微月淡芜城|飞萤纵复横|蛙鱼凉亦乐|跳港触荷声
中宵棹讴发|菰蒲翳明月|月黑君忽行|恐堕蛟龙窟
日落碧簪外|人行红雨中|幽人诗酒里|又是一春风
蜂翅初试黄|豆蔻花渐吐|小姑未许人|不敢下堂步
有意寻幽胜|跻攀固所怀|如今岭路稳|鞍马不须回
斜日回塘静|红莲花半开|双双鹡鸰鸟|窥影去还来
前山无夕阳|犹问夕阳洞|天寒人不行|山僧出相送
楼上吹箫罢|闺中刺绣阑|佳期不可见|尽日泪潺潺
心绪浑无定|春空百尺丝|梦随蜀帝魄|啼血向花枝
善处忧难作|能持事自修|腹心无外物|蛮貊亦怀柔
老火未甘退|稚金方力征|炎凉分胜负|顷刻变阴晴
三尺云根石|七弦焦尾琴|清风生指下|弹出古人心
六合同一色|二仪混莫分|何处瞻亲舍|茫茫尽白云
自来烟雨景|最是大通多|两浆迟迟度|江风未起波
一岁犹未满|九泉何太深|唯馀卷书草|相对共伤心
槿花不见夕|一日一回新|东风吹桃李|须到明年春
彩舟停画桨|容与得攲眠|梦破蓬窗雨|寒声动一川
参军玩世者|醉德不醉名|天地馀抔土|古今诵达生
参差江上笛|长似怨湘君|况复离群夜|高斋月下闻
昨日枝头红|鲜鲜染人指|今朝寻不见|已在污泥底
月晕大于屋|明朝风或雨|幽人总不出|斗笠久挂柱
狼来咋吾羊|猩来窃吾酒|汝为百兽王|不闻一声吼
暮宿见山亭|翛然心境清|饥民不忍听|那更候虫声
散影玉阶柳|含翠隐鸣蝉|微形藏叶里|乱响出风前
如梦复性坐|寻思境外忙|因缘开利钝|语默自清凉
欲别牵郎衣|郎今到何处|不恨归来迟|奠向临邛去
净居都葺了|馀地盖斯堂|不用栽萱草|无忧可得忘
既具顶门眼|逐得少林髓|南山梵王宫|规模自唐始
洞是何年辟|寻幽我乍来|拨云餐石髓|朵朵莲花开
灵岩竞吐秀|百卉四时开|不假栽培力|天然锦绣堆
涧沐爱深冷|晨光净如练|日出发未晞|白云满吾面
湖光初照耀|山意转氤氲|望望空明合|水天何处分
烟渚轻鸥外|晴峦画鹢前|何须苦联句|触眼白云篇
以此叶阴凉|代彼青琅玕|但恐本质脆|不堪期岁寒
行李晚萧萧|挑云过野桥|料应无别事|只是访渔樵
不可无此君|种得百千个|试与较风流|此君可无我
送君出南郭|江城春正明|重烟暗花柳|何处滇南程
晚日欣帘捲|凉风觉袂摇|远吟高兴遣|长醉宿愁销
主龙何处是|烟火两三椽|静卧知龙德|他时或跃渊
天台采药客|此地菜留名|流水年年恨|春风岁岁生
小月来相照|双眸老更青|人间无限事|且对静观亭
天池方半亩|半亩尽荷花|借问荷花主|蓬莱是主家
厓松何苍苍|下护幽人屋|夜寒不作声|为让幽人读
尽君一夕欢|滞我三百里|风波仕路间|相知亦能几
高低度岭频|清浅涉涧屡|恐已入天宫|山空无人语
何年流水恨|昨夜小桥春|纵有相逢地|都无可寄人
妾住小水边|君住青山下|青年不可再|白日坐成夜
月白天宇高|仰见明星烂|坐久不闻钟|舟人夜中饭
春云欲作雨|浮浮山带生|卧听芭蕉上|萧萧一夜声
朝同猿鸟吟|暮与麋鹿游|吾生有良愿|舍此当安求
阿旁□□□|严霜杀人鬓|刺□日千□|十年皆□尽
宜春新燕帖|正旦颂椒花|乐遇重熙日|东风改岁华
侵晓披头出|临窗教八哥|唐诗吟未会|一句只弥陀
风隐正扬舲|帆流带夜星|殷勤不肯别|似惜蒋山青
乘风发衡阳|徘徊此秋色|不因寄书来|休误上林翼
放闸冷泉亭|抽动一天碧|平地跳雪山|晴空下霹雳
客里逢秋景|思乡倍怆神|依然今夜月|不见去年人
杜门聊守拙|利禄念俱灰|旧雨曾来客|如今雨不来
草堂尘念少|岩壑有幽期|夜月孤山鹤|春风五柳诗
啄木觜距长|凤皇羽毛短|苦嫌松桂寒|任逐桑榆煖
斗醉石亦醉|无量不及乱|独醒谁得知|憔悴沧江畔
小瓮今朝熟|无劳问酒家|重阳明日是|何处有黄花
今观益公帖|老气肃锋铓|孙氏青毡永|宜开宝墨堂
谁把银河水|直从天半倾|好流人世去|一洗四维清
夜雪没毡城|闻箛三两声|漫山是猎火|照著汉家营
野船春浪急|烟柳夕阳低|流水南还北|行人东又西
不须冰与雪|自作一瑶华|人道水仙子|芙蕖是一家
节义穷方见|高名荐玉京|一封天子敕|千载故乡荣
雨过苔痕净|庭空日影迟|好怀谁会得|啼鸟在花枝
黎仲者谁子|将来夺宋香|饱自宜村舍|心先献尚方
霜白玉堂砌|乌啼锦树枝|小儿夸解笛|莫向月中吹
大醉一斗馀|条条似鲸吸|小窗风雨中|写竹难免湿
昨别征西幕|神闲务亦闲|此中可高卧|何必是东山
盛世适亲逢|楼台得地雄|无形兼有象|俱在太和中
通身百杂碎|谁解成褫得|鸡足紧收藏|当来问弥勒
瓮面蛆浮玉|槽头水滴珠|未能如茂世|聊与义城俱
迎气来归胙|宜春祝降祥|皇心勤治切|应喜寸阴长
萧寺吟双竹|秋醪荐二螯|破尘归骑速|横日雁行高
雨过江皋净|风来庭槛清|此君故人好|入夜听秋声
八月江气清|凉风吹不歇|扁舟忆远人|长歌对秋月
故里琴樽侣|相逢近腊梅|江村买一醉|破泪却成咍
月高长握笛|风急骤添弦|欲问来何处|青天但默然
巅崖出飞泉|百尺散风雨|空质丽晴晖|龙鸾共掀舞
池水清且涟|萦转牵曲镜|照见柳叶斜|不似莲花正
亭亭员干直|剪剪翠轮齐|叶散夜叉样|恶名谁品题
博山燎沉水|凤巢拥群娃|双烟结一气|烂漫凌紫霞
小鬟弹啄木|写出林间曲|空闻剥啄声|虚堂耿华烛
巧剪鲛绡碎|深涂绛蜡匀|残英枝上隐|逾月逞鲜新
采苦南山下|载咏采苦诗|舍旃复舍旃|此味人得知
山空云气收|风定水声歇|双髯发短歌|轻舟荡斜月
暖风欹绣帽|霁色称华裾|拾翠郊原遍|欣然共小车
快马金龙鞭|独出西苑子|道逢探丸儿|劫持是郎主
槛外当熊立|人情见亦惊|翩翩后宫女|冯媛独驰声
鹏抟九万里|篱𫛩飞咫尺|所以达观人|亦各适其适
日日花枝上|新声变转娇|何如逐鸣凤|天上协箫韶
心不择时息|书不择时观|达理意无碍|豁如天地宽
秋尽菊都荒|蜂犹采蜜忙|何如龟缩壳|此际已深藏
兹行览得失|抚己动兢愧|暮景尚可鞭|毋使寸阴弃
峰在西天竺|青莲千叶开|佛应无妄说|或恐是飞来
月色初元夜|花香剪彩春|而公高阳客|翻作独醒人
祖德道场下|往来三十秋|白头方问法|朗月特相留
幽花照寒泉|秋光翠欲滴|扁舟彼何人|遥遥渡空碧
载酒听莺语|春风到处吹|鱼峰如有约|蜡屐正相宜
朱夏郁蒸时|晶瓜碧玉滋|疏帘三尺雪|小簟一枰棋
人已就船眠|犬知何处吠|雨来闹秋江|全似茶铛沸
刘阮林中路|苏黄渡口津|不知之楚客|何似避秦人
云顶白泉飞|珠箔千重挂|仙衣惊尽湿|彷佛香炉下
幸有先人圃|宁辞灌溉劳|丛生诸菜品|最爱抱娘蒿
山中兰叶径|城外李桃园|岂知人事静|不觉鸟声喧
窗外芭蕉雨|檐前蟋蟀声|如将不平意|相诉到天明
北关怜翠幕|不是厌朱楼|故来呈燕颔|报道欲封侯
情亲由得意|得意遂情亲|新情终会故|会故亦经新
秋至池阁静|天高林薄疏|西园有佳处|那得与君俱
文杏作雕梁|卢家白玉堂|武陵双侠少|下马入垂杨
铁石挺孤标|冰霜抱贞素|一笑桃李空|嗟哉岁云暮
烟波愁独立|罗袜不沾尘|请佩人何去|谁邻江上春
我意岂在酒|衔杯聊乐天|客来同一醉|客去独高眠
汩汩寒流细|烹茶取漫流|有时来枕畔|添作一丝愁
白马看如练|苏台故是台|西施当日醉|飞向掌中来
花叶虽相似|青青有本心|亦知霜雪苦|不忍负空林
但爱梨并栗|不传琴与书|乃翁莫惆怅|它日举篮舆
魄依钩样小|扇逐汉机团|细影将圆质|人间几处看
已作亭下别|未忘灯下情|吟今欲就枕|更漏转分明
耕田消白日|采药过青春|有水有山处|无荣无辱身
缩席此相逢|摄衣遽然别|何以把赠君|清风及明月
花魂偏作妖|鬼血藏金碧|腐草亦成文|点点留斑迹
翩翩贤别驾|展足来帝乡|已见呈甘露|他年看凤凰
极目天涯路|孤帆千里归|倚门人不见|唯见白云飞
衰鬓频添白|病眼不成青|秋色无聊赖|寒光满户庭
我乐非君乐|君忧非我忧|蓬蒿与溟渤|终老不同游
问讯跛挈师|汝今亦知有|棒打不回头|乃尔能掣肘
能怀望乡思|慎勿上东楼|海气常常雾|淮声故故愁
悠然濠濮邻|会心岂在远|鱼鸟时亲人|不觉白日晚
斫破夜叉头|取出仙人掌|鲛人满腹珠|𫚔鱼新出网
迎风如欲斗|彻曙不知啼|旧得尸卿术|栽花总似鸡
东方之既白|睡仙方展眉|夕惕无遑逸|不息纵天机
三赋成会稽|四集始东楚|一洗凡马空|斯文有宗主
三十已专城|斯亦未足贵|潘舆归故乡|吾乐宁可既
只道沙坑近|招之阿那边|不知风雨夕|能过小溪船
思涩不自胜|援笔真欲迷|那堪屋漏雨|供此不尽溪
生长阳台下|分明见汉君|孤弦弹破梦|恍惚一行云
蔚蔚傲霜叶|亭亭绿池畔|莫言盈尺材|要是凌云干
二十学从戎|白头犹异地|谁知黑河流|尽是征夫泪
梳头看明镜|中有春蚕丝|明镜不解语|少年安得知
金蓓锁春寒|恼人香未展|虽无桃李颜|风味极不浅
怨莺新语涩|双蝶斗飞高|作个名春恨|浮生百倍劳
高人自无偶|独向亭中坐|日落山风来|时闻松子堕
朝登青石岩|十步一驻马|亦有红颜人|倚马立岩下
春色三分二|人生七十稀|蝶魂归蚁冢|花瓣泊鱼衣
多许明是多|少许明是少|倘遇苏摸棱|恁处讨分晓
卓锡飞泉流|人天大欢喜|来既无心来|止应何处止
桂树淹淮客|椒丘寄楚辞|风流沧海上|何羡习家池
辘轳何所用|注兹玉晶盘|阴山雪欲下|榻畔鸣琅玕
不及莲根好|泥中得偶生|鸳鸯花叶下|双宿到天明
河洛忘归路|东寻大吕亭|委心曾十载|不是爱沉冥
蚊眉自可托|蜗角岂劳争|欲效丝毫力|谁知蝼蚁诚
兹楼当胜地|高望极崚嶒|欲睹青天色|还须上一层
水上春霞明|花开几千树|不是避秦人|人疑避秦处
半抹红花满|山城物色新|楼台三界晓|花鸟万家春
春归阆风家|功入天匠手|能将五色云|点缀当户牖
长谷水千顷|青天月一轮|有尘飞不到|何处却生尘
双鹤栖华表|仙山自此通|云霞自扃锁|尘土若为攻
归路山花发|欣然折一枝|动容扬古路|不堕悄然机
金丸手自摘|色味香三绝|从来天者全|风韵迥然别
出游杳何处|迟回伊洛间|归寝忽成梦|宛在嵩丘山
采摘日盈筐|香生比目房|食多能益智|本草有仙方
净洗碧娟娟|颜色如少年|窗前风收雨|阶下笋行鞭
谁与一毫端|示此无垢相|迦叶不可招|始悟色空妄
卒然辄舛错|检点已千里|改是胡以预|造次必于此
尊酒为君开|醉来忘去住|清夜对床眠|梦残蕉叶雨
世事皆浮云|人间几朝暮|不知溪上山|犹有桃源路
东家亦有施|西家亦有施|不知花阿那|空自颦娥眉
佞幸传呼至|师臣伛偻迎|暮年灵寿杖|幸自可扶行
乍拂芳池远|还窥绣幕重|莫将花片蹴|飞舞满筵中
流传葛仙翁|此溪尝化龙|抱朴今何在|闲来问古踪
一雪顿能晴|江山万里明|故胜茅屋底|空听滴檐声
十月见蘼芜|青青似春浦|岂子歌长春|春色不敢去
点额有墨痕|剖腹无素书|俗视如顽石|仙骑上太虚
春风试茶处|潭上葛花开|去尽同游伴|伤心此独来
呼童汲清泚|怡然坐临池|谁能知我怀|细雨来催诗
曾排公子难|会是美人恩|偏馀歌舞意|潇洒叩柴门
幽鸟啼自哀|秋风竹枝怨|哀怨情岂胜|月明寒影乱
贾侯怀六韬|家有十二戟|天资喜文事|如我有香癖
空濛天外林|璀璨岸头石|何许放舟回|寂然方自得
乱山波上远|片片似修眉|山下蘼芜草|春来感别离
云水最饶处|轮蹄无到时|夜蟾生佛面|春雪印僧眉
芸阁藏诗谱|忘言对项斯|竹阴环短榻|况复月明时
麈尾竖新义|字字天机流|其柰溪边石|顽愚不点头
君留剑水浔|我卧弁峰下|十书九不到|思君无日夜
积雨初开霁|柴门掩薜萝|空阶堕梧叶|露冷月明多
幽谷生灵籁|虚岩落翠微|行吟兴未已|日暮竟忘归
块破擎拳出|盘行转眼空|救荒非小补|粉骨不言功
他乡逢素节|何处觅黄花|白发登高懒|将钱向酒家
独坐檐宇间|林端瓷清赏|空山日落时|满屋秋虫响
妾作下湖莼|郎作上湖莲|莲衣易飘落|莼丝长缠绵
片石翳云根|隐映波光晓|君看直钓翁|机静忘鱼鸟
窗中采莲舟|落日菱歌起|坐见浣沙人|红颜照秋水
楚岸云空合|楚城人不来|只今谁善舞|莫恨发阳台
恺悌见仪刑|从容侍杯酒|明月照孤桐|和风吹细柳
殿上俄流血|沙中竟脱身|乃知燕刺客|有愧汉谋臣
春陂昨夜雨|绿水潮来涨|应有放歌人|濯缨陂水上
平泉醒酒石|曾置洛阳园|却笑醉不醒|无由传子孙
轻雷不成雨|阙月却穿云|独倚南斋柱|长吟到夜分
秋云摇曳时|残声在高柳|谁传冷风姿|知是承蜩手
月出人未来|月缺人已去|好共借馀辉|相求直至曙
相识三十年|身颠心不颠|有人还会得|即是地行仙
聚书三十冬|插架三万轴|开卷时忻然|三公岂吾欲
大地龙正蛰|江山望禾黍|枝间闻女声|苍林自风雨
栽秧复拔秧|拔秧去恶草|恶草碍良苗|芟除故宜早
病骥秋风里|盐车道路长|他年践霜雪|矫首看云骧
庵中偃卧龙|阅世须髯古|人天共护持|半夜起风雨
海上碧云尽|秋天开素屏|怀中馀彩笔|无处著丹青
老懒问花事|尚与梅相看|苍然暮色至|只恐空吹残
迎春发苍柯|映日在琼萼|欣欣各自私|先开还早落
乾坤并万像|地狱及天堂|物物皆真现|头头总不伤
金斝又闻泛|玉山还报颓|莫教更漏促|趁取月明回
山水日已佳|登临同上下|衰兰尚可采|欲赠离居者
泉来草木滋|泉去池塘满|委曲到庭除|清泠备晨盥
汝返巴中路|千山尽子规|金陵啼不彻|况乃日斜时
稻花垂金丝|弱如红蓝蕊|风起飏蜻蜓|含香点溪水
习水巢登木|繁胎子吐生|似非凡鸟类|可惜捕鱼名
一凤领四雏|夜作吾伊声|梧桐高拂日|好去瑞尧庭
寒云将远空|叶落与飞鸿|汉苑秦陵外|凄凉是此中
此行殊匆匆|天色不肯借|更待海棠晴|满意孤山下
蹭蹬遭谗毁|空怀恋主情|贤人当重寄|或冀一人生
怪奇存相法|妍丑出天真|此君无二貌|正是葛天民
三三复两两|共偿丰湖约|谁云无管弦|鱼鸟皆成乐
剑客学神仙|十年不敢试|除却小有天|能无不平事
极目无边际|惟天与水连|烟中帆几点|若个是君船
青山无隙地|会景方卜筑|那知藩篱外|隐予诚亦足
马令园中本|移来村墅中|太官令却献|黄帕不来封
忆父去时语|迩来七十秋|终焉不忍冠|洒泪望秦州
日夕独往来|花竹静相对|身在万象间|意在万象外
柳丝不禁梳|桃毳不耐雪|梅残剪春绡|永日霏不绝
莫学卧鬓花|娇黄媚粉额|仙官道家妆|静处立标格
惜尾矜还顾|恋群娇不飞|从来美好处|须戒隐藏机
尺籍徵兵下|铜鱼使者章|临淄十万户|一半戍渔阳
一从辞宰粟|饥饿隐空山|货殖门前客|先生不启关
断虹跨曲岸|倒影涵清波|为爱斜阳好|回舟特特过
秋水坠莲房|幽禽语夕阳|故园归未得|飞梦绕林塘
六国钧南面|甘为北面臣|向微生一叱|几帝虎狼秦
夜直藉藁寝|入朝徒跣行|虽知迫明诏|可惜欠陈情
有生必有灭|无庵无可说|踢倒玉昆仑|夜半红日出
野药随宜种|芎苗嚼最香|屐痕休厌数|桤树逐溪长
手持净名经|高座挥玉麈|长爪何铮铮|庵头遍花雨
晨起山楼坐|微风度雁音|青尊酣白露|时动北窗吟
一琴复一觞|咫尺足容与|不作繁吹台|歌管日聒汝
又见梅花发|枝枝影向西|可怜千万片|飞不到潜溪
山果秋皆实|山花晚更馨|鸟飞时暗落|风静或微听
幽居抱孤明|怀古思旧京|渴望宝连山|老桂不胜清
云出山顶合|云归洞口封|地深人不到|白日下双龙
踏雪寻梅花|雪梅同一色|不是暗香来|梅花寻不得
拂拂生残晖|层层如裂绯|天风剪成片|疑作仙人衣
浩荡天游志|名山欲尽探|心将钟阜月|随子到终南
浓翠幕晴岚|春山古寺间|鸟啼花落处|曾共扣禅关
潘舆随五采|三釜古今荣|兰玉盈阶砌|追攀千佛名
重露覆千花|繁香凝畦圃|不忍日将晞|散逐微风去
莆城如斗大|征额钜万积|逭责犹未能|馀润安可得
象物名台势|琵琶出自然|登临得真趣|所乐类无弦
黄金买吴儿|明珠换楚女|七岁作鸾歌|八岁能凤舞
卧雪常山馆|孤吟气转雄|若逢洛阳令|闭户不相通
天上河如带|盈盈落翠微|可怜中宿月|空照白猿归
人境俱不夺|东西任该抹|七九六十三|相逢阿喇喇
半夜披衣起|宛在梅花村|梅花开易落|白雪长到门
山到江边尽|洲当水面横|鸣榔归浦慢|回首夕阳明
皎皎关山月|征人看作愁|几回曾破镜|何日大刀头
玉蝶正开时|绿稠红渐稀|移将永嘉种|梦逐漆园飞
乐事苦无多|良辰岂长见|明年缀席时|要使茱萸遍
有水足浮醴|宁拘秋与春|共将诗拟古|不必语惊人
美酒留人饮|乘风纵客槎|秋潭夜深月|春屿雨馀花
渴虬迸石出|下饮清冷湍|想当挥洒处|逸兴满毫端
百丈泻流泉|寒光净野烟|涧蒲多九节|服食挟飞仙
四十归燕字|千年外始吟|已将书北岳|不用比南金
团扇写横枝|吴华可含咀|谁知江南春|消尽人间暑
盱衡长史锋|缓颊中军笔|门外真长来|气压孙安国
洗耳在潭下|饮牛在潭上|白鹭飞复来|烟中立相向
仙老不知年|相逢问九转|袖中出宝书|历历皆云篆
同年三百辈|荣悴几经心|复送君家去|离忧岂易任
投我白羽扇|坐君嘉树林|池花照人面|池水清人心
寒食少天色|春风多柳花|倚楼心目乱|不觉见栖鸦
不见僧中旧|仍逢雨后春|惜花将爱寺|俱是白头人
怅彼荆榛合|欣公杖履开|倘非人隐异|何许笛飞来
休嫁弄潮儿|潮今亦失信|乘我油壁车|去向钱塘问
子春恐事败|佟之坐水淫|二者过不及|何如我洗心
闻有南河信|传言杀画师|始知君念重|更肯惜蛾眉
青山不改色|绿树有新姿|昔人歌舞地|今见草离离
血气有盛衰|理义无损益|理义要常胜|毋为血气役
春池深且广|会待轻舟回|靡靡绿萍合|垂杨埽复开
怡老堂前竹|如君好弟兄|裁为双玉琯|吹出凤凰声
凤皇具九苞|是为众羽王|鹰鹯有劲翮|乃亦健翱翔
微雨朝来歇|红芳缀满枝|多情花里鸟|应爱日迟迟
洞小沿花入|花香出洞新|彩云飞不去|留作洞中春
莫讶萱枝小|能施宫样妆|只缘沾染足|绝似杜兰香
难与助为理|聊复共偃卧|文叔迫我甚|客星犯帝座
春夜常如岁|何妨秉烛嬉|百花俱中酒|万竹自吟诗
台城遣恨多|山阁今独倚|玉笙何处来|月照乌龙水
南湖莲未稀|北湖莲已乱|鱼畏来舟潜|鸥惊去棹散
直舍灯明里|还摛应制文|宵寒霜漏永|赖此助微醺
岭北芭蕉树|虽多不著花|岭南花且实|香者在龙牙
古邑今为田|城闉复何有|时见遗世人|长歌一回首
巢馀太古雪|人有正始风|头如雪絮白|面作春桃红
君从蜀江回|遗我一端锦|鸳鸯穿芙蕖|飞上合欢枕
华屋落山丘|悲歌咏曹植|故有主林神|百年依正直
商也能为政|明时尚棘栖|万公窗岫色|何似对梁溪
异乡寒觉早|故国信来稀|秋风江上望|一雁正南飞
江南拨镫法|寂寞冷天涯|阿谁春雨后|貌得翠蛾眉
汗虱亦我液|疥虫亦我肌|喉间冲败絮|鸟爪复奚为
瀑峡生烟暝|山杯坐不归|笼灯过潭水|疑有玉龙飞
接叶深为翠|双葩浅作黄|因怜合欢意|纱幕覆鸳鸯
直节豸献角|低枝鸾振羽|古色镇苍然|非烟亦非雨
溪水绿悠悠|高楼在溪上|日暮望江南|舟中采菱唱
西湖多胜景|飞盖喜相陪|暑气迎秋尽|江声向夕来
移根近轩墀|不使众草没|会见黄金英|泛我杯中物
清贞表独立|半蕊便风流|信有魁天下|群芳未转头
郁郁长条抽|林间翠堪剪|背岭山气浓|幽人趣不浅
挟策博塞殊|愚智相千万|反躬诚且乐|此事要早办
苇绡攲鼠穴|翠质临螬井|自破核不钻|通行冠可整
但见蹙红巾|未闻衣黄里|一试缕金裳|世职真西子
池上无陀石|千人列坐曾|如今趺夜月|唯有一山僧
迢迢清夜梦|应到集灵台|翠羽凉风发|还从水殿来
匣中三尺剑|天上少微星|勿谓相去远|壮心曾不停
小驿维梢坐|来帆自若飞|不堪游兴尽|欲作向南归
何敢爱筋力|无劳戒励重|但当知讳字|闻说是雅中
杨花池上飞|燕子梁间语|从此送春归|能消几番雨
幽芳不自媚|白日净依依|风露已如此|山中人未归
明河欲西垂|树杪大星落|隐隐远烟消|霜天一声角
十年红紫□|容易怨春园|不向瓶中见|还从檐上看
急雨捎溪足|斜晖转树腰|隔巢黄鸟并|翻藻白鱼跳
钗安葳蕤爵|耳施明月珠|试向小姑看|小姑道相宜
理甓完新甃|披沙挹旧清|一瓢遗味在|隽永若为名
残历馀几日|坐叹年光促|不须悲旧年|洗眼看新绿
莲生污泥中|其叶何青青|人生有恒性|云胡荡于情
回飙送雨来|岁暮寒云起|鸣弦杂散丝|隔坐闻流水
立缟芳桂阴|置汝固已当|他年莫姓丁|止厕子侄行
仆夫顾且惊|于菟啼林薮|乃是巉岩傍|流泉挟石吼
天风开瘴烟|独立山椒雪|神人藐姑射|相对成二绝
云生不翳空|日上难逃影|相逢一笑中|何须重反省
客随陶令遣|斋甚太常严|傥或非黄奶|那知此黑甜
芳草鹧鸪啼|东日复入西|我亦南归客|闻之泪满衣
大音易销沉|天地终何有|茫茫东海沙|斯人岂长久
笏引上天梯|鞘鸣奋地雷|谁云天尺五|亲见玉皇来
桥上山崚崚|桥边石齿齿|差畅游人怀|奈伤驭者趾
屋外山云湿|门前溪水寒|禅心安未稳|明月上蒲团
君耳污□□|□□□□湾|首阳落第二|前已有箕山
昔时炼液人|凿井湖山侧|即今井中泉|犹带丹霞色
尔来鲁泮新|快睹戴席重|下舂分尺光|乃与此际逢
家寄江东远|身对江西春|空见相思树|不见相思人
山阔青连海|溪长绿绕城|规模唐故郡|弦诵鲁诸生
兰阶兔月斜|银烛半含花|自怜长夜客|泉路以为家
宿昔青云志|蹉跎白发年|谁知明镜里|形影自相怜
手轮摩尼珠|身坐盘陀石|普请大地人|念彼观音力
岳莲清入梦|倦眼为谁开|五季纷纷尽|真成一觉来
江连云气合|海近旭光侵|不是春能住|林峦深更深
佳节虽逢菊|浮生正似萍|故山何处望|荒岸小长亭
娶妇今六载|止遗一女婴|诸弟俱未婚|尔目安能瞑
涓涓万古意|湛湛一尘无|明月来窥镜|宵寒露滴珠
万朵锦云新|天涯赠美人|谁知江上色|却掩洛阳春
世治其术重|世乱其术轻|太平然后用|用然后太平
山中雨欲来|树杪风先起|犹有试茶人|偶坐松萝里
家近神仙宅|苍松一径遥|闲来弄泉石|无意问参寥
一水限天河|秋来月色多|酒船轻似叶|何事不相过
晴村多暖霭|花处是轻烟|梅片纷纷下|迎人到酒边
秋色延高台|台荒庙亦冷|两三樵牧儿|投石试深井
山馆欲分襟|况是春归节|不惜落花飞|惟愁与君别
将军虬须儿|谢病久卧床|宝刀绣已折|犹有战馀疮
沙明渔浦近|水落钓船低|野树长含雨|山云欲渡溪
逆溪随水行|更上紫翠峰|朱栏忽飞阁|映带烟霞重
事从尘世去|心共白云闲|不作游山计|朝朝饱看山
收驹汧渭间|谁识此老骥|伏枥我何伤|著鞭渠可畏
藏亲已云竟|思亲那可忘|写亲藏魄处|朝夕似亲傍
我性野而率|山林谩求安|有酒固可乐|无酒亦自宽
尘榻为子下|柴扉为子开|从今断还往|一室长莓苔
远山浮青螺|旋涡入烟水|此去上螺川|迢遥二千里
夜静银河冷|天高玉露清|双星缘底事|千古若为情
中流击孤艇|危亭四无壁|微风水上来|衣与寒潭碧
红亭瞰碧流|鱼戏日沉浮|玩此心同乐|方知得自由
洁白虽堪爱|腥膻不那何|到头从所欲|还汝旧沧波
清波左蠡分|秀色东林接|日射金芙蓉|香炉晚明灭
宝殿春朝退|瑶池夜宴深|明朝是人日|时复问晴阴
彼美不自献|置之玉子冈|珍重保灵璞|春雨欲流肪
脱巾以漉酒|酒熟何淋漓|感君光似月|照我鬓成丝
闻道龙城野|金苞亚绿云|么么三两树|何处比封君
周君凭小榻|自说懒无疋|要学陈希夷|一睡四十日
水深莼茎肥|水浅莼茎瘠|四月泖湖莼|紫者堪留客
彩帛曳长虹|悠悠卷塞风|三军齐陷阵|应在一挥中
醉中还有梦|身外已无心|明镜唯知老|青山何处深
白刃甜如蜜|清流险似波|羊牢须壁立|臧谷较无多
百卉尽摇落|独傲清霜里|披榛见黄花|渊明元不死
嘉阳信美郡|风物眷多奇|有湖题明月|有楼名荔枝
应怜夜度娘|动寒往相觅|可畏双行缠|已落雪上迹
竹色上墙多|南薰绿几何|时无分付处|野鸟自来歌
狭路转多歧|多歧可问谁|试询曾到客|犹似未来时
火老不知秋|萤飞风露下|和月立梧桐|幽人宜独夜
伍奢呼二子|一至一奔焉|逃父吾无取|雠君亦未然
策马访柴扉|庭前草亦□|谈今复谈古|如子□□□
击筑复击筑|欲歌双泪横|宝刀重如命|命如鸿毛轻
相送临高台|川原杳何极|日暮飞鸟还|行人去不息
公退紫薇省|宅种紫薇花|千树临山麓|秋来粲晓霞
柴门雨萧萧|径添一尺草|为惜青苔深|十日九不扫
天遥归雁尽|雷动蛰龙腾|万里蓟门路|殊深此日情
我亦狂涂竹|翻飞水墨梢|不能将石绿|细写鹦哥毛
投暝宿前湾|占风夜未阑|月沉鸿雁渚|云起鲤鱼山
空荒咆熊罴|摧残没藜莠|平生江海心|其人骨已朽
雨溢忽飞泉|泉流注深谷|我欲往从之|褰裳濯吾足
乱峰排鸟道|一水会龙门|禹力不到处|犹如沧海尊
旬宣既南国|保厘复西土|著绣还故乡|朱节震华鼓
山势犹龙凤|行宫已劫灰|北人偏怅望|曾见汴京来
后夜溪山雪|临门望子猷|莫因清兴尽|半道却回舟
耿耿曙河微|神仙此夜稀|今年七月闰|应得两回归
穫水登红稻|篙舟割紫菱|杯盘见秋物|江海思飞腾
坐望九华碧|浮云生晓寒|山灵应秘惜|不许俗人看
三五穷荒月|还应照北堂|回身向暗卧|不忍见圆光
断岸馀衰柳|轻舟泊浅沙|西陵南下路|多是野人家
可堪开画幅|秋思满江湄|惟有随阳雁|年年朝北飞
流泉自清泚|片石激成泷|午憩留孤枕|尘心此处降
寄语同参人|切忌随他转|若向句中寻|相逢不识面
寄语林和靖|梅花几度开|黄金台下客|应是不归来
江上亦秋色|火云终不移|巫山犹锦树|南国且黄鹂
探奇兴不尽|秋思满林薄|祇园掩夕阳|小坐昙花落
踪迹谢尘泥|精神动寰宇|我为苍生忧|呼尔作霖雨
谢家芝兰庭|更着几松盖|堂堂老翠圆|撑住青天在
口浅不能食|眼深多咬人|猪膝难任重|焉堪致远行
散乱萦花坞|空濛暗柳堤|望回肠已断|何处更莺啼
晓起西园望|空阶散落红|自嗟根蒂浅|不敢怨东风
南海春天外|祇应学水仙|自伤迟暮眼|为我一潸然
万木一时暝|众峰倦无声|惟馀满湖月|半夜向山明
买药囊无金|伏枕头有霜|夜深不得睡|隙月射秋床
徘徊侍高轩|云闲足觞酒|微酡下清溪|斜日筛杨柳
维天降灵雨|岂不雨石田|我自硗且确|枯悴莫怨天
斜阳过亭西|纵目随所适|何处一鸢来|飞飞破晴碧
落日照前溪|倒影映红树|幽人不出山|白云自来去
转蓬本无依|侬愿作转蓬|飞飞千里道|或与君子逢
托根蟠泰华|倚干蚀莓苔|谁云山泽间|而无梁栋材
大面窈深处|神仙碧玉壶|孙郎妙心眼|催作后山图
心中万虑息|独立发远想|举头望天堑|北风吹五两
名父难为子|纤瑕即辱身|直须留面目|他日见先人
寂寞先贤墓|千年马鬣坟|可怜七十子|德行几如君
桑柘隐寒墟|牛羊杂乱石|林果摇青黄|已纵飞鸟吃
日光明骀荡|天气暖氤氲|草木遍庭槛|清香朝暮闻
望远音书绝|临川意绪长|殷勤眼前水|千里到河阳
相聚即为邻|烟火自成簇|约伴过前溪|撑破蘼芜绿
滃然集清冷|无厌亦无受|故此岩下池|予名曰无垢
见疾多朝士|争名卒未休|急流须退勇|焉可又随流
窗隙针来大|霜风圣得知|耳边如箭急|直把菊花吹
下马问老仆|言公赏花去|只在近园中|业深不知处
黄皓贪无已|蜘蛛总不知|苦瓜一两颗|枯竹两三枝
雉意感尼父|鸿冥说商山|风尘谁不厌|君早去人间
九日山僧院|东篱菊也黄|俗人多泛酒|谁解助茶香
春水抱芳洲|宛宛紫檀槽|羽人歌洞章|不省郁轮袍
松柏岁寒节|谷风夫妇心|千年如有护|为作老龙吟
欢归夜何其|月照临门别|后夜待欢来|开门但明月
楚歌一声发|吴侬双泪涟|武昌应尚远|船是武昌船
修竹凌青冥|乔林郁苍翠|三世托吾庐|嬉游十经岁
谁知瀑布里|亦有一人家|多谢溪边鹿|来寻不食花
厌践冰霜域|嗟为边塞人|思从漠南猎|一见汉家尘
酒阑歌已阕|解佩灯先灭|罗帐隔清风|玉腕摇明月
郑兴亲未葬|张籍眼多昏|何时解印绶|归去卧山村
忧来纷无踪|浩若烟雾聚|又如春生草|屡剪不可去
矶头系渔艇|林下访樵牧|炯然一白鸥|独有满潭绿
子规啼不歇|到晓口应穿|况是不眠夜|声声在耳边
钟鼎非吾事|神仙亦世稀|停杯忽惆怅|明月上人衣
薄暮风色寒|移舟宿前渚|欹枕不成眠|孤篷夜来雨
湿湿云生岱|晓晴山崦红|仙人来种玉|二耜亦同功
草草临池墨|萧萧落叶风|高情不可见|怅望越江东
后夜客来稀|幽斋独掩扉|月中无旁立|草际一萤飞
身高吸霄瀣|羽薄趁仙风|自奏清商曲|泠泠山水中
花上月纤纤|蛾眉映绣帘|从今三五夕|相伴客愁添
揽别如昨日|桃花空复春|盈盈川上月|好为照征轮
昔闻诗中画|今见画中诗|芭蕉生雪里|只有辋川知
万缘正繁兴|当处即解脱|当知本来空|不受汝摩撮
禁火晓未暖|踏青昏恰归|何堪一原雪|将冷入春衣
霜树寒犹劲|风涛急未流|高亭天畔色|寂寂半江秋
初谓武陵远|移来不计春|近传湖户警|愁杀避秦人
五出稍敷露|不受尘目爱|鲜鲜著精神|独于此时最
青泥生莲花|凌波自轻举|今日散花人|昔时采莲女
野处竹为邻|衣冠似汉秦|战争浑未已|空老看棋人
飒尔金飙过|嘐然冰弦响|彷佛百尺桐|仍栽峄山上
朝日城南路|旌旗照绿芜|使君何处去|桑下觅罗敷
英魂招不起|应在此徜徉|红绿波相映|真成锦绣乡
上山望大河|旗帜十馀里|不知何处村|但见青烟起
翠辇西湖路|雕盘北苑花|时平无外事|随意趁年华
浅浅黄金萼|匀匀白玉英|天风随御驾|吹满九重城
崖悬怯吾顾|潭空沁我心|匪斯涉游趣|敬慎识官箴
冬雪亦自佳|此意向谁论|推窗试一观|天地正混沌
青青原上草|鹡鸰飞复鸣|何日南湖上|连床听雨声
天下分三国|江东美二乔|英雄方割据|何暇咏桃夭
簪玳尚谁继|风云那可看|自曾许持送|谈笑未尝乾
龟峰归遇雨|彻夜鸣不歇|起望昨游处|惟见满山雪
山堂有何观|四时互兴歇|万物随天根|东生复西灭
赏得秦王镜|判不惜千金|非关欲照胆|特是自明心
人行𡼭岭上|时与岩相突|马落溪桥间|忽为雪所没
平安常有报|径造岂无期|万里相思意|为欹淇澳诗
烟水小长芦|微茫子大夫|不知垂钓罢|亦复著书无
江寒月黑夜|定宿蒹葭里|叫叫过灯前|却是谁惊起
昨日日暮别|今日日暮愁|犹认纵裙色|依依在石榴
松风传地籁|花月满庭心|记得金台下|孤樽细细斟
生涯得力句|尽被维摩说|空劫一壶天|泥牛耕破月
乾坤皆我闼|民物可相方|大学西铭意|皇风陋汉唐
春水如天上|秋潭见月中|如何列禦寇|犹欲待泠风
海天秋似洗|渺渺净烟涛|忽露珊瑚树|还看翡翠毛
淋淋沥沥行|仄仄𡼭𡼭远|此去浮屠街|二十四泥坂
山雨夜鸣屋|凉秋风满林|一贫才到骨|万事已无心
人言江南乐|江南信不恶|冬杪宛如春|寒花发新萼
诗筒连画卷|坐看复行吟|想像南湖水|秋来几许深
火枣侑神梨|金浆调玉醴|但与许道士|不与许长史
蟾宫有兔臼|捣药千万年|药有长生术|世人无计传
莫竞梦中鹿|且视指端月|傥能心地明|万事一毫发
晚日东西路|秋风长短亭|悲歌浑欲绝|衰泪不胜零
晚色净娟娟|文禽亦可怜|一双荷叶底|誓死不孤眠
可怜秋海棠|春暮已争开|金丝与西府|并作一香来
晚潮常带月|夏雨不过田|身世江湖里|人家水木边
野树桔槔悬|孤亭夕照边|闲行看流水|随意满平田
拥昭初辅政|汉室大将军|符玺郎能尔|丹青见不群
淅淅风生砌|沄沄水满塘|藕根穿土阔|茭叶过人长
天低云有影|日午塔无阴|极目三秋望|登高万里心
清晨戒童子|竹户不须开|昨夜东风恶|苍苔有落梅
树影连村暗|荷香隔岸闻|移舟向南浦|惊散鹜鹅群
忆别河桥柳|青青送马蹄|妾心与羌笛|无日不辽西
𫗦糟同啜醨|醉倒横路多|谁是独醒者|听唱铜鞮歌
山水有清音|琅然出枯木|若教俗耳听|丝竹不如肉
远水孤云没|清川去鸟闲|兴亡千古恨|日日对青山
寒衣裁已定|非是妾疏慵|有线无针引|教妾何由缝
海水无南北|潮声日日来|归人今海外|乡信寄潮回
粲烂五花骢|轩昂八尺龙|惟应天厩里|得似画图中
朝吟东渚风|夕弄西屿月|人境谅非遥|湖山自幽绝
寒波白似面|远岫劣于眉|江上无多作|淮南正要诗
太阳一入地|亦足蒸成霞|老学傥能勉|声绩岂不华
欢年十五足|侬今十四馀|不羡双栖鸟|那怜比目鱼
塘上挽船人|塘泥深及胫|落日望前村|心将道途竞
叶似青云剪|花如碧玉凌|鸟来栖不响|朵朵巧垂铃
一别春城雨|两回秋月圆|灯前不尽醉|书札但空传
秋声在何许|潇潇一庭竹|明月入疏棂|来照幽人宿
春从此中来|还从此中去|山客未眠时|潇潇西林树
坐亦岂非行|行亦岂非坐|问我我不言|笑舞溪云破
自与美人期|芳草日转碧|今日凌寒者|岂独松与柏
雨作糟床注|秋生鲈鲙思|卷帘了清景|沉水袅烟丝
石梁双跨溪|虹影倒涵水|斜月未堕烟|烟中市声起
士非耕钓者|而从蓑笠翁|人生贵适志|莘渭亦时中
古庙郁崔嵬|朱门傃道开|今人不为让|间或乞灵来
何处月明桥|花宫对浦潮|即今明月夜|时有客吹箫
切切暗窗下|喓喓深草里|秋天思妇心|雨夜愁人耳
挈枕上高楼|银床凉似水|对郎弹箜篌|恐落邻家耳
扇暍仁风广|蠲烦瑞露瀼|万方沾润泽|安用沐兰汤
何代金谷园|斜连上林苑|十里看花人|五陵紫骝远
去年春日盛|七十庆仪新|今岁从头数|重过一万春
秋深风落木|清水半池荷|驱马向何去|吴门客子多
广园临碧沼|曲径绕青扉|竹雾笼金勒|松风护锦衣
偶向武林游|曾于天竺住|明日欲离山|晴霞故变雨
江水汇为泽|瀰漫深万丈|山寺晚钟鸣|湖心明月上
溪叟挈笭箵|曾来候此亭|未知余不杀|刚要著鱼经
鸟鼠是家川|周王昔猎贤|一从离子卯|应见海桑田
海底红尘起|山头白浪飞|若能如是会|永劫堕泥犁
连骑出都门|秋蝉噪高柳|落日辞故人|自醉不关酒
行到溪源尽|青山无俗氛|道人拈铁笛|吹起满川云
驻马高溪侧|旅人千里情|雁山山下水|还作此泉声
公子与王孙|何须更问耕|春心为花雨|梅杏尚难平
盛德初临震|阳和已动坤|发生天施大|厚载母仪尊
天风振枯梢|独立何所营|愁胡休侧目|海宇已清平
苦雨已解严|诸峰来献状|不见白头禅|空倚紫藤杖
杂遝今观渡|依稀昔浴沂|居人空巷出|几个咏而归
落墨生幽思|风来自有香|九天皆雨露|容易拂云长
有爱即耽著|竹色共花光|何似无心人|尧桀两相忘
玉座见图叹|累累菜色民|如何崔白辈|只写蔡奴真
夜游西园渚|初日光炯炯|徙倚岩石下|爱此林中影
东风留客棹|白日此登台|帆影来无际|江声去不回
浅井供茶灶|分流浣布沙|此泉吾所爱|百用给山家
谈笑三军却|交游七贵疏|仍留一只箭|未射鲁连书
偶随白云出|不掩白云扉|有客坐来久|山僧归未归
牵路沿江狭|沙崩岸不平|尽知行处险|谁肯载时轻
暴乱免遗折|森罗贤达名|末郎何所取|叨继外门荣
月黑耕人语|隔河见白马|知是精灵归|来向庙门下
白涧含清光|宴坐夜方寂|起视天宇宽|月明露花滴
昏小脑搭重|路粗半节儿|棠梨三角额|此等不须题
带牛移汉俗|匣刃出酆城|安得治复古|器农不器兵
汉殿炎风少|轻凉已动衣|每来观织室|不许夜停机
湛湛冷山骨|幽幽抱日光|晓吟看雨气|春供汲花香
景景照幽房|荧荧吐焰长|昔年江上女|曾向乞馀光
早有看花兴|烟云竟不开|每当花时节|肠断几千回
出塞男儿勇|还乡女子身|尚能吞北虏|断不慕西邻
半岁吏尘役|天书教放归|思量难报称|安稳饭和衣
虚舟泊回潭|烟澹水容夕|谁解沧浪心|山空月下白
山坪萦雾草|湖泺漾烟芦|野色谁延入|阴晴足画图
后土祠前路|金鞍忆旧游|春风双燕子|浑似在扬州
沙鸥故飞飞|湖雁更历历|顾我亦忘机|相看同一适
乱烟笼碧砌|飞月向南端|寂寂离亭掩|江山此夜寒
休种江头柳|长条空自妍|春来郎别妾|不系木兰船
半空隔风雨|万壑闻长松|我往采三秀|骑龙莲花峰
棹船淮水上|晒网赤岸南|船中捕来鱼|卖钱买鱼篮
唤作忘忧草|相看万事休|若教花有语|却解使人愁
永日静无聊|空庭散郁陶|憩禽猜落果|乳雀趁飞毛
绝代有新祠|松篁映林麓|岁时荐江蓠|遗爱动民俗
插天两乔松|下有两翁语|异日坐松根|还能具鸡黍
流莺拂绣羽|二月上林期|待雪销金禁|衔花向玉墀
暴虎须袒裼|冯河必褰裳|想公川上叹|谁与共行藏
叶暗前朝雨|花飞昨夜风|空山人不见|春在绿阴中
蜻蛉橛头船|自度还度汝|一夜曹溪风|吹散黄梅雨
东山西岭青|雨下却天晴|更问个中意|鹁鸠生鹞鹰
叶叶双芙蓉|半蚀土花碧|乍可千岁埋|不借一夫力
隐约菱歌断|斜阳水面移|美人贪照影|不觉画船攲
玉茗深宫里|春妍带雪残|可怜五色羽|相并不知寒
门轩湖水北|四面芙蓉渚|望望楚天遥|孤帆带飞雨
日没浮图昏|遥钟出烟岭|应有未眠人|泠然发深省
鸦乱暮林近|鲈肥秋水深|江南无限好|图画亦关心
秋月映秋波|清彻世无比|犹似见亲心|泪洒枫湖水
勒马问樵夫|前村酒有无|杜康家在此|一任君来沽
芳心自凌乱|翠带常绾结|日暮望佳人|璚蕤不堪折
众景纷骄蹇|君独著语亲|十诗已椟藏|不与俗子论
秾薰知见林|燕坐观物化|鼻孔如撩天|可闻不可画
吴绫光𫄥𫄥|织成鲸掉尾|美人不敢裁|恐触波浪起
晓雨生池荷|圆珠漾新绿|入手不成珠|空歌彩莲曲
开似未开时|芬馨不自知|微风吹不远|清梦最相宜
避暑白云乡|茶甘齿颊香|海城悲暮角|烟树淡斜阳
巨石平如掌|天然状鼙鼓|击之还有声|分明含太古
庵中有高人|不受红尘触|吟诗每夜深|来伴山云宿
骅骝事天子|龙怒拔老湫|鼓枻视青旻|烈风无时休
卿家日湖东|定家月湖西|送侬打两桨|先为到慈溪
野树映晴川|舟横古渡烟|分携如不忍|相顾意留连
暑湿深山雨|荒居破屋灯|此生无忏处|此去作高僧
不了一毫事|空捐七尺躯|陶惜其人没|雄才以盗书
人谁独无母|汝母良可悲|汝饱讵几乎|亦有生子时
解使回肠断|能催两鬓秋|天涯未归客|容易上眉头
雨馀苔藓上|泥以燕衔香|一片馀春色|依依在画梁
纤腰何太瘦|疏影乱婆娑|昨夜西风急|空庭落叶多
吴山碧相续|具区深不流|孤舟行薄暮|短发照清秋
清风满竹林|酌酒荐鸣琴|悬知大小阮|于此开尘襟
冬耕春复犁|麦秀禾方插|少放牧儿休|莫教牛力乏
山险者夷之|梯以石齿齿|于间遂成台|有梅适堪倚
蓬巢饱山果|负子浴前溪|啼冷巴东月|令人两泪凄
双鹤摩天去|双泉为谁久|昨夜王乔过|山僧尔知不
东西二十里|相望两平桥|傍水多投钓|穿云有负樵
江上朝阳洞|无人肯暂过|今来惬心赏|回首恋烟萝
不忍与君别|怜君仁义人|三年官满后|依旧一家贫
辟谷几经尘|如芝今有神|更开三益径|似恐太无邻
晴坞夕阳媚|煖梢春意留|讵须吞绛蕊|方解解人愁
日晏歌黄鹄|时清茹紫芝|君心天下独|天意独君知
至老能无倦|真为善事亲|叔褒非佞者|何事拜邻人
我少不努力|常愧夜讽子|亦有才高人|雍容即登此
风来无限思|雨过有馀凉|眷彼君子心|漪漪在沅湘
郁郁冰壑姿|株株手亲植|欲知来去踪|双峰耸寒碧
山中时节早|地势近春华|岁岁东风至|先看傍砌花
草木衰残意|关河离别情|秋风已如此|况复更论兵
铁爪玉龙鳞|红冠不染尘|五更才报晓|惊动世间人
细雨红初熟|薰风绿满林|采时留几颗|明日饲山禽
两眼断夕阳|两鬓羞临镜|重门闭不开|唯与愁相竞
明月无长好|晴空有晦时|君家那与我|头白似新知
河泗争流处|水流心不流|自流他自止|吾与止流休
清宵难独寐|谁把曲来讴|曲里声声思|离人辗转愁
面势来空翠|哦诗独好仁|怀人今已矣|谁遣栋梁新
蔓菱翻翠浪|菡萏含西照|酒令严乡音|屡犯还屡笑
厌市冲烟入|忘怀对客迟|吟看飞鸟没|坐到夕阳时
生长邯郸下|少小能鼓瑟|君王好新声|宠爱一朝失
大厦要直木|郢斤弃如遗|一朝谏省上|王魏不支持
官闲有新作|寄我莫惮远|兼书海陵事|令我开病眼
不见蛰根时|唯喜苍阴覆|借汝叶间声|当我风信句
跂首望蘅皋|远目聊增明|相逢定何夕|剧谈到参横
落日青丝骑|西风白苎词|广宁门外柳|折尽向南枝
山开仪凤门|江断卢龙石|三宿昔年人|泊舟总陈迹
立马古堤边|翩翩美少年|别怀都不语|折柳带青烟
吾家白玉树|璀璨已横枝|尽可参霄汉|莫教伤别离
呼吸一寒暑|三界本无家|人间自火宅|未老发先华
陈生赠我剑|今复几春秋|眉目隔河陇|恩情在枕头
岩石多意气|松树留高龄|倚仗眇云涛|天风吹泠泠
泉飘百丈带|曲折下流溪|车水村村急|春苗莳未齐
夕阳欲下山|一半恋流水|短笛牛羊归|馀光照童子
滟滪拓瞿塘|二孤障澜蠡|大哉神禹功|天地相终始
朵朵玉为盘|金黄向里攒|樽中欢酌尽|酒量不知宽
里巷占新岁|皆云胜旧年|几回新岁过|万事只如前
枌梓交游尽|灵光岿独存|声名今绮皓|公论自推尊
主人方濯缨|寒花照芳芷|未惜春树残|上有青青子
新挑锦字书|倒指岁月远|愁眉要深黛|灯花已堪剪
悠悠江湖思|扰扰声名累|溪上见芦花|宁无慊然意
石路绝经过|山云自来去|欲共麋鹿群|当在幽深处
家住阊门外|笙歌搅独愁|三年空见雁|两鬓易惊秋
长驱桑乾源|破敌飞狐口|万里清烟尘|月明击刁斗
元鹤栖幽径|声鸣达九天|会心知万里|暂寄百花前
左持鹦鹉杯|右把鸬鹚杓|拍浮酒缸中|生计长不恶
小睡呼不起|白云常在家|篱边十笏地|梦里也栽花
烟火几渔家|边湖夹疏树|扁舟三五人|坐入秋天暮
缅甸实如瓜|垂金粲秋色|谁刻紫琼瑶|玲珑投远客
檐日阴阴转|床风细细吹|翛然残午梦|何许一黄鹂
虫响灯光薄|宵寒药气浓|君怜垂翅客|辛苦尚相从
有角翻害身|沉泉避刀剸|故依金地慈|非惮沧溟远
花香专引蝶|非蝶亦飞来|顾影不知耻|良为贪者哀
独坐捲湘帘|空阶雨初歇|掩泪忆蛾眉|不敢看新月
翟公既罢官|人弃理亦贱|殷勤莫署门|交情不必见
兹地有神宇|人人来荐羞|神虽能介福|福亦自须求
古木带回溪|来寻径路迷|莫惊春事尽|花在野桥西
形影一朝别|烟波千里分|君看望君处|祗是起行云
金镞因形制|临畦发永叹|时危思撷佩|楚客莫纫兰
腊月二十五|人家祓旧年|山人无可祷|睡著不知天
丹籍生涯浅|黄泉归路深|不及江陵树|千秋长作林
花石今何在|孤城涕泪中|金梁桥上月|偏照宋遗宫
鸥鹭雪衣明|忘机更闲暇|青青芳草间|袅袅垂杨下
柳叶遍寒塘|晓霜凝高阁|累日此流连|别来成寂寞
江夜雨浪浪|春风难禁当|匡庐云雾里|半月到浔阳
荷锸入中条|云霞导双屐|山腰翠渐微|冉冉孤亭出
南雪不到地|霏霏满竹楼|沙河灯市里|春在木绵裘
飞鸟随风叶|梨花漾碧晶|溪山得圆净|鸡犬亦萧清
溪回岸影深|山迥溪声响|独有溪上人|扁舟自来往
角豆穿篱石|丝瓜绕屋椽|打畦分嫩韭|春雨翠呈鲜
竹暗不通日|泉声落如雨|春风自有期|桃李乱深坞
果哉糟粕矣|煨烬莫疑秦|韦编三绝后|谁是醒经人
霹雳振秋岳|折松横洞门|云龙忽变化|但觉玉潭昏
四时循化机|万物随动息|众星纷荧荧|天运齐拱北
老爱风霜饱|将裁紫玉轻|江南秋色远|龙笛有新声
绮席偏宜昼|香霞独占春|洛阳荆棘久|谁是惜花人
书蠹犹堪读|囊萤亦强观|竞辰规后学|继晷匪油乾
花蒂流金水|知从秘苑来|春风如解意|不敢起纤埃
秋风吹白波|秋雨鸣败荷|平湖三十里|过客感秋多
百丈深涧里|过时花欲妍|应缘地势下|遂使春风偏
一任笋侵疆|何防鞭碍道|千户广侯封|三家结村保
溪南越乡音|古柳渡江深|日晚无来客|闲船系绿阴
莫作溪流看|天命无穷已|诗人若知得|千古可坐致
调高尝寡和|境绝每无邻|持留一席地|安顿世间人
连檐对双树|冬翠夏无尘|未肯惭桃李|成阴不待春
白云最深处|时有伐木声|长歌互相答|澹然忘世情
烟叶正青青|轩窗晓思清|开帘看春雨|江上有歌声
人言二月时|霏雨生树杪|天色何时光|要向寒食少
近江乔木里|彊半棣华栽|叶覆青青蔓|相沿别树开
生我者为母|无缘贵贱分|不思骂婢语|何可使亲闻
春晖开绣户|日日理残机|机中千万缕|织作云锦衣
明月照前墀|朱弦奏流水|春风如未回|敢望无云起
光风浮碧涧|兰杜日猗猗|竟岁无人采|含薰祇自知
王业偏安日|文章尔独醇|谆谆似伊训|初志亦耕莘
清池浸苍崖|草树临绿静|应名洗玉渊|亦号岩花镜
此心天地宽|幽亭寄闲静|独坐卷疏帘|落花春昼永
乱雪从教舞|回风任听吹|春寒能作底|已被柳条欺
方差能腊腹|学误至渐襟|幸有经文在|休于注脚寻
志一气以动|气一志以随|持养使清明|和平毋暴之
曾访罗浮隐|梅花别有村|旧盟寒未得|移植卧云轩
灵篆贮纱囊|熏风绿鬓傍|从今能镇胆|不怯睡空房
东塘水初满|西塘泉又生|春风两塘侧|多少路人行
迹与孤云远|心将野鹤俱|那同石氏子|每到府门趋
倒景虞渊日|馀威泽国霞|宵行逐明月|水宿傍人家
平生无町畦|任真但落魄|烂醉是生涯|天地为棺椁
竹下有幽径|本为裘羊开|清风满庭户|时闻抱琴来
何事须明心|神通无更有|一朝心其心|宇宙在吾手
徒闻管弦切|不见舞腰回|赖有歌梁合|尘飞一半来
濯缨与濯足|均是沧浪水|个里不胜清|渭神爽应泚
溅沫响空谷|分流清法筵|元因卓锡地|今为洗钵泉
霞绮明如画|江花染欲流|可怜江上梦|红粉故园愁
爱此松风吹|柴关抱麋鹿|白眼四无人|涛声满空谷
好个重阳节|谁家酒不赊|果然杀风景|吸茗对秋葩
朝吟还自酬|暮吟还自酢|年光整整来|山房人亦乐
龙出潭水空|龙归潭水黑|君从龙床来|谁在龙床侧
寒塘潮渐满|暮艇赴潮归|人语烟中集|鸟惊树上飞
尝闻岷峨下|往往多长年|把赠李氏子|归以寿双亲
人生易与耳|一饭当倚栏|妇蚕子耕耨|辛苦输县官
雷听西江近|帘观太华低|斜阳恰春意|来照种花泥
梅蕊初舒日|闲庭菊未披|诸儿频进寿|群搴旧赐衣
喜晴弹玉指|林下见幽人|楚楚湘灵样|肌肤不染尘
蝉声随落叶|飘堕枕头边|我心与空际|胡为白昼眠
渔人榜小舟|诘曲桃花水|鸡黍能相邀|问津傥来此
吾家何处住|一嶂独成围|莫遣通樵斧|应嫌减翠微
些个失人意|愁肠百叠萦|却诧元城子|梅州鼾睡声
云树微茫里|江流浩荡间|舵楼烟雨重|不见九华山
物理窥开后|人情照破时|情中明事体|理外见天机
为巢倒悬树|窍窍自成房|螫人虽有毒|终为人所伤
江汉云重阻|秋风白发多|相思不相见|木落洞庭波
自昔为神树|空闻蜩鵙鸣|社公烦见辍|为尔致羊羹
乔林众鸟集|暮气氛氲上|好在三巴山|何时正相望
问春何处来|春来在何许|月堕花不言|幽禽自相语
初作眉头皱|还成簟面斑|小风来不住|织遍一池间
别君四载馀|联床遂一月|涤荡千古怀|只字不可说
古木参天迥|青山载酒多|谢公墩可拟|词客盛年何
岁暮阳关路|愁君匹马行|离心似春草|一夕雪中生
为爱三山色|金焦问法幢|一酌中泠水|浮杯夜渡江
北风吹海色|飞上姑苏台|欲问吴王事|秋深麋鹿哀
危事经非一|浮荣得是空|白头官舍里|今日又春风
过市摩双眼|惊嗟阅盛衰|朱楼倚霄汉|曾见始成时
三十六峰外|疑皆松所成|巨灵多变怪|一一本无情
邻人不贷牛|一荒连坐九|同我妇子馌|出入互相友
一泓碧澄甃|寒沁玉壶清|裹茗曾来试|虚闻石井名
江湖存魏阙|翰墨寓规箴|君看龙眠画|当识鸱夷心
不如池上藕|花叶得相连|花落莲房见|青青子可怜
昌江真陋邦|芋魁的盈尺|逐客方阨陈|饱食度终日
结宇依空谷|秋来多白云|前山浑无赖|日日下斜曛
家人迎医至|与语岐黄事|答言君已知|挥手请相避
日月东西照|支江南北流|鹭飞如导鹢|横吹不惊鸥
利名何足事|山中乐未央|郎如学耕耨|奴便学蚕桑
托根长水石|正与幽人宜|更看成九节|服食比华芝
具舰逃安往|焚巢溃不支|区区一州力|不足辱王师
过雨千林湿|高斋色自肥|箨龙一夜长|片片紫云飞
康乐烟霞屐|长房日月壶|有乡皆是醉|无谷不名愚
庭树应如我|相逢益老苍|别来秋苦雨|但觉瓦松长
江头落日明|江上西风起|岁岁芙蓉花|开落秋江水
龙尾湾头渡|长船挂一帆|前年北行客|今日几人还
异世犹相惎|同时必见攻|区区一枝笔|悔惜与文通
君自故乡来|应知故乡事|来日绮窗前|寒梅著花未
画史先盘礴|一择敌化工|万事未当前|胡不虚其中
久病欣初愈|长忙爱暂闲|出城因送客|沿路得看山
鸾路迎长日|农祥正晓天|九垓同燠沐|万物向蕃鲜
古人重言德|初不论倾城|切莫伤容鬓|犹堪嫁孔明
我程可默数|中秋过江池|趁得江南米|新舂玉满箕
怪石与枯槎|相将度岁华|凤团虽贮好|只吃赵州茶
学得琵琶曲|深宫不忍弹|水晶帘幕下|寂寂倚阑干
秋水光于黛|新妆爱日斜|隔溪深不语|孤棹入菱花
出岫本无心|云在意亦在|松桧无高枝|舒卷何所碍
昨日十分春|今朝几聚尘|可怜傍辇者|有愧坠楼人
贤人骨已销|墓树几荣凋|正直魂如在|斋心愿一招
春风杂花池|宾主两相视|落日忽已晴|洗盏可无醉
终南成诟厉|所处失其亲|遥揖山灵语|慎居捷径人
生意苦不繁|托根那计畹|只怜君子花|西风亦相偃
树下彼何人|不语真吾好|语若及日中|烟霏谢成宝
愈风陈有檄|止疟杜能诗|虽然医者意|何意亦何医
击碎轩辕镜|焚烧黄石书|瘦筇春力健|带月访樵渔
一年春好处|寒食一百五|想见束晨装|沙头震鼍鼓
缑山曾一弄|仙响更寥寥|到此聆清吹|重瞻鹤羽飘
流泉自清写|触石短长鸣|穷年竹根底|和我读书声
结叶还临影|飞香欲遍空|不意馀花落|翻沈露井中
野老从余话|文公在半山|蹇驴追不及|落日寺深关
阴凉生研池|叶叶秋可数|京华客梦醒|一片江南雨
雨后桑田暗|风前麦浪浮|柴门人迹少|深树自鸣鸠
斜阳客如画|路转丛薄间|惊禽忽冲起|似石投前山
桥下一飞泉|散为诸瀑布|泉界罗与浮|仙人不得度
骏马蹋铜蹄|金羁艳陇西|郎应重意气|妾岂向人啼
水树声疑两|山云三两峰|石床间坐久|独对一株松
逆知生女主|预说覆唐宗|误杀五娘子|安知在后宫
午漏奏新诗|昕朝召节飞|若非梁武帝|谁识谢玄晖
袅袅竹成竿|累累花结子|永怀不寐人|空闺愁欲死
十丈红莲花|凌空生太华|仙人持作舟|直泛蓬瀛下
秋去菊方好|天寒花自香|深怀傲霜意|那肯媚重阳
深林四无人|秋意满长薄|日暮牛羊归|寒烟出篱落
谁接东洲本|稽山浪得称|他时红粟颗|知映玉壶冰
读易北窗前|不知日已暝|新月悬林端|松风洒萝径
桂楫方东泛|荷衣已出尘|曲江寻相业|犹是姓张人
红紫斗芳新|韶华满眼春|绿窗深院里|应有惜花人
闻说山中路|经年断客行|山人理归屐|莫遣绿苔生
云中萝幌开|石上苔衣冷|古调人不闻|谁能发深省
双剑分二峡|万古水溶溶|邪气夜常动|精灵日少逢
义兵昔来过|石上马蹄在|遗响寄滩声|英风凛何代
掾死缘非命|儿来哭未休|旧时亭下泪|疑与水长流
架竹引龙须|时攀颔下珠|欲求西域种|北使昔同符
千仞崇山顶|清泉何处分|涓涓石涧底|一脉下青云
团扇复团扇|羞郎引遮面|顾景强踌躇|隙月云端见
前滩跳白鱼|银鳞长一尺|呼童拾鱼归|寒山煮白石
城分二江急|树入九峰开|地隔犍牂绕|人从楚蜀来
呼童清晓起|扫却门外雪|日出消作泥|惟恐涴幽洁
不薄论交意|因书稍稍知|还将天下眼|照破老夫痴
鸟咏短长句|花呈赤白章|化工非不巧|闲客笑春忙
霜凋青草枯|玉貌委泥途|妾泪空盈掬|君恩只按图
浅水难容棹|繁花自作村|分明幽绝地|不是武陵源
谁骑苍鸾来|啄破苔花碧|经年不归去|化作山头石
秋风吹竹实|朝阳照梧树|定有吹箫人|来此山中住
秋风吹我夜|植杖溪桥侧|木叶虽未凋|惨澹无颜色
话别秋堤畔|寒蝉声更悲|夕阳孤棹去|正是落潮时
晚艇村村载|秋原处处收|年来尤爱此|一熟缓千忧
雨花台上游|黄金馆头别|一鸣空骥群|排云叩阊阖
朽壤虫遍蚀|枯藜蚁倒行|姜生黄菌蠢|茄熟紫膨脝
深藏西竹寺|寒拥北谯城|石字赞皇古|泉铭庶子清
十载干戈后|辛勤莳牡丹|岂知身是客|借与别人看
门开日影来|一片苍苔色|花气引游人|山风吹未息
荷深水风阔|雨过清香发|暮角起城头|归桡带明月
一代丝纶寄|千秋保障名|高牙拥大旆|西入晋阳城
驭世既阔疏|赋性复粗梗|圣恩天地宽|使我全首领
蹇人欲上山|秦帝欲上天|假令天可上|地上少人烟
柳嫩风摧绿|花娇雨妒香|欲凭羲驭缓|莫遣负韶光
风絮鹅毛乱|春畴鲜血肥|恼侬故乡梦|鸟劝不如归
片月照金闺|纨扇不堪把|珠帘上玉钩|霜覆鸳鸯瓦
司寇今欲行|病叟山中卧|如闻经略忧|未向春风破
骐骥方腾踏|蚊虻敢扑缘|明年小期集|请看十庐鞭
山矾䆗以窱|花木郁萧森|一障红尘隔|幽人何处寻
佳人谅诚素|鸣佩若可取|王孙忘情事|不学郑交甫
定林在何许|窈窕钟山麓|得非夸娥民|遗我障岩谷
雪里跫然至|人间无此清|瑶田今夜鹤|下听诵诗声
我词不足录|聊以醒渠醉|更参三十年|当与风子对
采得昆冈玉|连云种小亭|月华润灵雨|虹彩烛苍冥
前年征塞北|今岁戍边西|几度占归信|空惊乌鹊啼
莫耗官仓粟|休贪御手羹|新年采薇食|诗比旧年清
采菱秋水旁|惊起双鸳鸯|独自唱歌去|风吹荇带长
每到花开日|携觞坐此亭|醉来拚一笑|不为访玄经
泛槎惊误客|折齿笑狂邻|不作回文字|愁嫌愁杀人
桃花被东岸|江水日日深|赠君岂无言|亦有花水吟
昨夜开红槿|今朝听杜鹃|落花频有改|啼鸟自年年
羹鲤稻粱餐|沈思欲答难|只裁残拜帖|写竹当春盘
何物瑶琨石|龙宫夜不函|由来江岸侧|天造补陀岩
涧水流红叶|浑同二月花|武陵多错认|深处有人家
名利真成祟|英雄奈尔何|清江平似席|倏忽起风波
湖上望君切|江上送君苦|江上与湖上|计程一千五
生长沧波中|收罗向书室|剡藤无不平|祇恐无椽笔
平川开远景|倦客忆先庐|数里闲云在|东风过雨初
香炷对清晨|微言得问津|所师非传癖|手泽仰如新
远近皆僧刹|西村八九家|得鱼无卖处|沽酒入芦花
有德名终大|无为福自延|更闻天子孝|荐术助长年
武夷溪九曲|曲曲可垂钩|自得溪山乐|何须公与侯
廿载悬尘壁|何人问此琴|可怜兵火里|此辈乃知音
仙人白玉掌|半出五云间|好去寻芝草|移栽王屋山
昔献长扬赋|风云四海生|遭逢圣明主|礼乐秀群英
阴光浮石壁|长如春水生|僧归夕磬后|回首见西清
何时太夫人|上天回哀眷|墓久狐兔邻|呜呼泪如霰
月姊应吞怨|无人写所思|柔情将绰态|须是破瓜时
数雁来山外|听莺立柳边|黄麻金马诏|青史玉堂仙
边人冬更猎|往往得山熊|雪点貂房白|冰凝肉酪红
组绣出闽中|由来习俗工|何如此君节|叶叶是清风
塞北烟尘息|江南胜气多|君王总戎旅|来继大风歌
辛苦夷人妇|鱼篮各在腰|纺丝还夜夜|舂米亦朝朝
翠竹浮烟浦|芦花落雁洲|澄江明月夜|随意弄扁舟
顾渚吴商绝|蒙山蜀信稀|千丛因此始|含露紫英肥
朱襦千里变|金弹一分增|入口蜜相避|怀归谁不能
来日绮窗桂|开芳已满丛|如何攀折处|犹未达秋风
富贵浮云尔|死生一梦焉|此中谁解得|空诵远游篇
一点伤春恨|看成两鬓霜|如今无此梦|莫画两鸳鸯
岸闪波光旧|花争柳色新|闲携苍玉杖|犹忆华阳巾
彼哉市道交|出语指天日|未逢魏与裴|三叹扁斯石
诏发西山将|熊虎亘阡陌|笳鼓凝皇情|佳气向金阙
弱蔓引修藤|垂旒泫水晶|忆曾江路见|风露熟秋棚
不分镜中鬓|持向问秋风|何事烟霞客|年年世网中
策马二十年|常怀颠蹶忧|蚩蚩弄雏者|真乘百斛舟
盘桓抚孤松|千载怀渊明|岁寒挺高节|吾自含吾贞
节逢重九日|郡占五溪间|止水痕依岸|行云影过山
入林疑入城|八月如盛夏|晓来闻雨声|急起看花架
黄彭骨已蜕|何年遗两山|我寿年龄外|后地与先天
三年望东林|几日又当别|盈盈谷水波|一苇谁共折
晴蜻舞幽涧|水鹊立枯槎|予亦坐烟壑|有生俱有涯
细雨长途暝|投装处处艰|何如高枕夜|清兴在兹山
客子夜中饭|策羸出又返|虽非倒马关|竟似回车阪
散步出西堰|迤移山路长|秋兰漫堪采|赠子为衣裳
前面热未退|腰胯却行迟|是热须医热|少将冷药医
坐石弄芳草|渡溪行翠微|西峰月未上|独自看云归
春阴亦已缓|春草亦已长|良夜非三五|起视明月光
深入荷花里|红妆映碧流|香风传笑语|不见木兰舟
妖娆破瓜女|争上秋千架|香飘石榴裙|影落蔷薇下
兹石不解饮|偏饶饮者意|若遇独醒人|应无其坐地
卑服即康功|君王俭德隆|却颁罗与葛|恩渥被群工
桃李是舆台|清芬独有梅|孤山千古意|今日为君开
雁飞霰频积|马饥冻犹策|谁怜东郭生|尚作长安客
谈谐意方接|萧散诗自生|写成澹泊句|洗尽淫哇声
卧龙拜床下|刘表安能屈|照见采药踪|犹遗鹿门月
残堞馀秋草|颓垣带夕阳|当年曾下士|谁为语兴亡
寒茭翳秋塘|风叶自长短|刳心一饱馀|并得床敷软
独树邮亭影|千山征路尘|东乡今夜月|偏照未归人
阴阴蚕月雨|如沐亦如酥|绣佛花前供|还堪浴也无
竹原与草堂|转眼事非旧|一壑今独专|造物有付授
我醉辄指麾|莫向太帝说|要炼五彩石|去补西天缺
骑马渡河水|马渴未即渡|饮足不须鞭|腾踏长嘶去
石桥高百尺|雨后振衣上|我欲驾铁桥|仙人共来往
北阙投封事|南山返故庐|李衡千树橘|张琰一园蔬
楚山十日雨|高涨落江湖|捲雾游龙去|粘天白鸟呼
同俗不同俗|山杯映秋菊|仍闻席上歌|不是人间曲
莫道春风好|春风易白头|君看花里鸟|亦有世间愁
市廛有宽征|僚吏无间言|弊例亦麾却|益知彦修贤
人人欲见圣|岂以面目求|由之乃克见|真见惟真修
雨渍身如漆|苔侵面若蓝|问时都不语|应是忆扶南
牧牛值风雨|牧具几脱手|不自风雨前|不自风雨后
空江满秋色|回首见东山|旧日垂竿侣|攀龙久未还
万里江南客|思乡无限情|白头谁作伴|清夜读书声
阳过常畏人|阴过不畏已|人目当其丽|吾目当其鄙
此花犹未发|此酒已先香|独有甘芹意|开樽略为尝
晴春日蒙茸|远客自惆怅|白云乍散彩|青山还遮望
涓涓自空来|霏霏复不见|安得自尤物|使我耳目乱
化国春偏好|慈闱日自长|仙韶喧法曲|齐劝万年觞
僧舍兰亭帖|萧郎取得还|昭陵一片墨|依旧出人间
秋风下太清|摇落不堪情|喜有东篱畔|黄金乱吐英
广殿回雕辇|沧池漾彩舟|尧心顺时令|不是重嬉游
飞雪透疏棂|隆寒袭重被|乡心触景生|惆怅难成寐
我爱千亩杏|逶迤围小亭|浮云日夕静|叠入万峰青
蹛林闻野祭|汉室议门诛|辛苦楼兰将|凄凉太史书
鹦鹉海上杯|一酌起云雾|最得五柳欢|那免三闾妒
纷然丧乱际|反覆归圣朝|秉钧孰为偶|扶颠永萧条
斋心礼仙圣|不是爱山游|山中笑何等|白发故诸侯
菩萨号文殊|禅堂名曲讲|语默本同源|名实不相愯
好学无闻焉|佳兵吾衰矣|且乐荣启期|不羡鲁施氏
洑流几千里|往往见清川|汇作荥河泽|奔为趵突泉
开帆驾洪涛|血战乾坤赤|风雨闻号呼|流涕洒丹极
无食又无衣|逐儿安所之|不辞履霜苦|犹谓罪当笞
横枕山窗里|月明林影动|禅心烱不眠|宁有巴山梦
古桧依堂陲|曾闻昔贤植|岁寒霜霰多|不改青青色
春着湖烟腻|晴摇野水光|草青仍过雨|山紫更斜阳
静抱五龙寐|虚涵一镜空|洞天三十六|都在卧游中
风急窗自鸣|霜严酒无力|岁律方峥嵘|幽人坐坚壁
一片韩山石|千年卧荒草|崚嶙何所前|落日牛羊道
微尚依林壑|相期载酒过|窗前双瀑布|清响坐来多
瑶琴空石几|肠断未成声|听待他年鼓|熏风指下清
认得前家令|宫人泪满裾|不知梁佐命|全是沈尚书
读碑经岘首|贳酒过宜城|莫问依刘事|休伤吊屈情
出上才双叶|抽心已一花|色应欺翠羽|香未减兰葩
青青水中蒲|叶短不出水|妇人不下堂|行子在万里
复寄满瓢去|定见空瓢来|若不打瓢破|终当费酒材
昨日泸溪客|今朝此问津|野航吾自惯|一度当寻春
藁砧不可期|莲子空相托|欲寄一封书|惟愁被姑觉
绿树凉阴合|苍苔掩翠浓|共言春意好|都在满林红
春光才一点|已觉早梅清|不是香含吐|安知最有情
柳暗夏将至|花残春欲归|年华似流水|无语叹光辉
数日方离雪|今朝又出山|试凭高处望|隐约见潼关
手摘卷葹草|愿传双飞翼|车轮千里遥|中心自不隔
清澄寂灭海|明净涅槃天|到此方知乐|休耽浊睡眠
妾把青铜镜|郎投玉镜台|芙蓉照秋水|似向水中开
野旷孤亭迥|昼长花影迟|蒹葭飞白鸟|杨柳啭黄鹂
凿破苍苔地|湾湾月半边|既能清到底|何必十分圆
举世多少人|无如这老汉|不是倒骑驴|凡事回头看
梦见关山候|愁闻风雨时|羁人新荡样|月影下波迟
水面细风生|菱歌慢慢声|客亭临小市|灯火夜妆明
醉翁虽已没|遗构在山阿|不比陶潜石|清时乐自多
不肯一世人|草木自宾友|举杯问樵岚|见有此客否
日射江门动|龙蟠海雾生|排空有羽翼|不上九天行
野烧千里尽|容易雪消时|莫以春先绿|都忘寒岁知
郑君高节士|潇洒绝人群|独把青鸾尾|山窗扫白云
新栽竹数竿|竿竿挺苍玉|我歌竹和之|步转阑干曲
开樽酌溪渌|秋兴何萧骚|重哦惠休句|目送吴鸿高
风流意不尽|独自送残芳|色作裙腰染|名随酒盏狂
思见怜初洒|忧消喜渐堆|惜明聊自拟|惊密偶同欸
结客千金尽|酬恩一剑存|羞为狗盗伍|不傍孟尝门
绣斧肃霜威|澄清志不违|瘴乡人拭目|惊喜见晴晖
穷达渠非命|机关不到心|新诗聊自遣|高兴若为禁
卷却银河水|青山应更清|等闲评陆羽|来此读茶经
不畏塘雨急|钿叶自相遮|纹禽忽飞去|冲落波上霞
萝衣湿寒翠|苔锦上嶙峋|一榻千峰里|因诗忆古人
心向静中求|身宜闲处著|合已号便便|亭宜名莫莫
藤石从云老|苔阶过雨斑|游人不解看|应道是真山
世事今何日|深居独灌园|夜来焚谏草|偏愧舌犹存
与君外形骸|更自离言说|此聚虽难常|此意终不别
花龛高挂天|飞影不著地|鸣铎下虚空|谁悟岩头意
种豆豆苗稀|力竭心已腐|早知淮王术|安坐获泉布
寒山草木疏|苍翠因雨湿|日暮来不来|前溪借蓑笠
愿海散香风|花披菡萏红|锦鳞方上钓|金锁已腾空
章句传燕国|风流有薛君|千年濠上意|寂寂向谁云
凿石破苍苔|青天地底来|夜深寒月印|疑是晓奁开
石阑瞰虚碧|满院兰花开|揽衣起结佩|匡坐待君来
簿领久沉迷|谁能不忍欺|我来惭此石|拈出问吾师
解虎锡常闲|饲虎石常在|亡躯度有情|清风几千载
呼韩与汉盟|保塞临洮西|斩马玉具剑|挠酒金留犁
路远嗟来晚|山僧梦已痴|敲门惊破胆|撩乱佛菩提
夏木无重数|森阴翠樾低|相呼百禽语|太半是黄鹂
来时帘捲昼|坐久竹移阴|有待无消息|南窗睡兴深
寻春入玄洞|水帘珠错落|下蟠九仞松|上宿千年鹤
繁盛闽南粤|潜藏霜雪天|素云生宝髻|剩馥借龙涎
端坐阅四时|烂然各有第|新篇敌岛可|邮筒当数寄
空馆寂无人|摵摵鸣木叶|乍疑风雨声|忽见当窗月
常闻南郭智|未识北山愚|试问溪中水|潺潺只自如
一望二三里|烟村四五家|楼台六七座|八九十枝花
淑气欲迎年|朔风将送腊|征衫费增减|渐觉寒暄杂
彭泽归来后|东篱菊正黄|秋光无限兴|晚节有馀香
窗前六出花|心与寒风折|不是郎归迟|郎处无冰雪
四望黯同云|平湖堕银汉|一叶柳边来|应是寒澌泮
问路非行路|年年在户庭|果然行路客|问罢即登程
自湖腰欲断|莆阳朱紫半|水绕壶公山|此时大好看
欲妆临镜慵|畏见朱颜老|无语下瑶阶|所思在远道
岁晚经湘浦|堪收入画图|雪馀凝望处|一片玉模糊
晴日催归路|平桥又息躬|云峰四面碧|霜叶一溪红
庭花昼合围|松竹蔽行道|淡面邀缁流|相对豁怀抱
独在西峰顶|年年闭石房|定中无弟子|人到为焚香
台高登望迥|台平驰射宽|平高各有志|民力空独难
望母嗟陟屺|思亲徒望云|可怜魏孝子|不比狄参军
蕉叶碧逾净|榴花红更明|知秋惟蟋蟀|唧唧草间鸣
太液轻澌泮|温明霁日融|菜流芳荇碧|花颂瑞椒红
气至风条达|阳升土坟盈|芸芸生物遂|两两泰阶平
游子惊西风|霜意薄林樾|所嗟故山蛩|不负故山月
心事俱已休|名山尚留踪|芳湖清且浅|曾照汉时容
帝子登湘岸|临风粉泪弹|梨花多少雨|点点透琅玕
翛翛叶打窗|瑟瑟珠跳瓦|长夜未眠人|起听孤灯下
府教英灵在|虺蛇不敢居|从来岩上月|只是照虚无
人兮吾与游|竹兮吾与俱|世浊此独清|室小自有馀
阶下苍松立|阶前白鹤行|轩中何所有|终日此双清
空阔湖水广|青荧天色同|舣舟一长啸|四面来清风
一朵归云静|徘徊正好看|匆匆恐惊散|不敢上林端
孤舟泊柳阴|邂逅一论心|玉带河头水|此情应共深
日醉临邛市|不题临邛壁|怯他卖酒人|胸中五云色
见说灵州战|沙中血未乾|将军日告急|走马向长安
老树馀生意|疏花发故枝|平生心铁石|正在岁寒时
难把父书读|祗因手泽存|遗言汝可受|忍使世无闻
一念私才起|风波势便增|若非鏖战勇|方寸几时平
瑶台明月凉|玉琯回双凤|不知谁氏女|参差隔花弄
帝遣银河垂|虚帘荡空渌|我欲买娉婷|问尔乞三斛
濯濯何年有|先公手种成|至今揩痒虎|来认读书声
一丝公不挂|钓饵也怜渠|旧日垂竿地|临流只放鱼
古柏昼阴阴|当轩岁月深|山僧常笑指|应解识禅心
宝塔镇东方|亭亭三鸑鷟|云中挂暮蟾|海上射朝旭
当时虎符臣|千载羊裘友|试看元勋台|何似山祠久
迢迢烟水寒|猎猎霜风侵|此行何当还|民瘼简帝心
策杖独行游|青山一何深|道逢采药人|问我松脂林
密竹藏啼鸟|荒村起白烟|人行秋色里|家在夕阳边
白水明崖草|青云起暮山|春风凉不绝|归鸟恣闲闲
著意绣鸳鸯|双双戏小塘|绣罢无心看|杨花满绣床
胡羯自干纪|唐纲竟不维|可怜德业浅|有愧此碑词
住处何曾远|林间别是凉|清风酣一枕|底许觅羲皇
君试探玄草|吾能把素书|问奇频载酒|真作子云居
救溺如救火|造次遂捐生|金陵人去远|拗鬼不来争
甘泽终妨骤|春缘闰候迟|较量农早晚|西墅野棠枝
吏事君休怪|山城好闭门|此生无长物|但坐有清尊
虎为百兽尊|谁敢触其怒|惟有父子情|一步一回顾
首言天地易|次语赞羲皇|系传谁精玩|先看第一章
孤舟横野渚|明月照当空|十年江海意|疑在小亭东
秋水自然碧|秋花何意红|乾坤摇落恨|只是为西风
浙山高崔嵬|浙水清缭绕|廓然霁风霆|孤月生夜照
百年樵斧外|留得挂寒猿|不奈西溪水|流香出洞门
陟彼白云洞|洞里白云迷|跳出白云外|身与白云齐
无怀三两人|裹粮杂乾豆|连日醉乡游|不记归时候
多病宜逃世|浮名合敛踪|杜门安偃蹇|自性本愚慵
神疲穆满驭|足茧神始载|终然方寸心|扰扰躯壳外
天如碧玉版|群山各写形|高空无障翳|龙凤互鶱腾
子真岩石耕|名称动都邑|不比北山翁|销声寄禅寂
异哉宗子孝|亲疾远关心|每念痛大小|因知疾浅深
别兄今几时|邦人指难弟|莫诵海沂康|两冯如鲁卫
我爱姑射仙|清标似霜雪|误落风尘中|玉颜总如铁
月映山头秃|云迷路口叉|仰天方索句|一鹤立松丫
曾饮桂山茶|未登桂山路|芒鞋白苎衣|相约游山去
玉环碎一声|回首峡山暮|安得如萧郎|乘鸾携手去
茅茨西日暖|翁媪自相依|不识鸳鸯意|双双作伴飞
南来山不尽|北望意何如|恨杀衡阳雁|来时不带书
短烛空烧柏|浊醪不荐椒|岁华知几日|人道是今朝
庭树谁教种|无端恼客情|昨宵窗外雨|一半是渠声
流光不肯住|烟景复相催|寄语看花者|休携玉笛来
秋色山中好|山翁醉不回|不知篱下菊|霜后几丛开
轩居只数椽|一角横池水|城中车马尘|那得来窗几
浮图屹亭亭|乘暇一俯仰|忽然风雨来|檐铃一齐响
山前杜宇哀|山下杜鹃开|肠断声声血|郎行何日回
海上洛迦山|现我大士影|萧萧翠竹风|此中有深省
学得汉宫妆|偷传半额黄|不将供俗鼻|愈觉更清香
白日不飞出|夜灯安可亲|比朋不可投|何似暗藏身
万里关山静|清阴满塞榆|如何金殿里|犹献辟兵符
迎风绿云翻|含春锦苞吐|何处双彩鸾|飞来斗毛羽
溪边花满枝|百鸟带香飞|下有一白鹭|日斜翘石矶
纵令无目生|不如有心死|惜哉高氏筑|仍作荆卿匕
玉甃祥光发|难藏世上名|定多慈护力|一饮百疴轻
宵分睡正浓|忽闻鸡喔喔|强起整衣冠|明星在屋角
谁把摩尼珠|掷向沧溟里|皎皎镇江城|至今潮不去
平塘波浪深|荷叶鸣秋响|惊起锦鸳鸯|双双共来往
山水有馀静|都忘城市嚣|朱黝本自省|时焉此逍遥
劲节含龙箨|孤标出凤池|最宜风月夜|不遣俗人知
老树半垂叶|疏篁斜露根|若无烟雾隔|应见石西村
半空纷下鹤|千尺矫游龙|再歌古人句|晴雪落长松
猿声到枕上|愁梦纷难理|寂寞深夜寒|青霜落秋水
窈窕东注壑|舒徐南入江|寄声沧海若|高洁此难双
碧草垂低岸|东风起细波|横汾从游宴|何谢到天河
疲筇扪石上|大野俯栏窥|洞穴通诸顶|泉流接两池
根清条不肥|影落明月地|凄凄欲寒时|胚𣍯已生意
游蜂从何来|饥雀巧相遇|谁其释纷拿|放汝采花去
主人心地阔|以意名其亭|长携一樽酒|坐对前山青
密林新雨歇|叠壑泻潺湲|书声午未罢|深坐觉□寒
萝月娟娟净|三星耿耿明|曲栏深睡犬|修竹暗巢莺
苞竹秀孤岭|虚籁涵清漪|秋风何时实|凤饥竹不知
白日炎氛远|清阴敷广庭|岁寒抱高节|霜雪独青青
破白便怀青|纡朱旋著紫|鼎鼎一春忙|浮荣均梦蚁
汝幼不努力|忽为三十馀|勉旃教汝子|要付善和书
明月今宵满|清谈暑气消|鸥飞蒲叶战|鱼跃浪花摇
凄凉徒见日|冥寞讵知年|魂兮不可问|应为直如弦
昔我游山阴|杂花纷似雪|重来雪作团|远树皓已结
取友英隽场|如子乃石交|进善定见与|言从浚之郊
儒道未易行|俛首为禄仕|仕而不得禄|卓哉见廉吏
茆山千万叠|不得见天全|帆出扶胥口|无山只有天
寂寂中秋夜|含情出玉闺|河长看雁远|月皎觉云低
平昔歌声断|凝尘满画梁|昭阳新奏曲|谁得奉君觞
雪后竹君子|霜前松大夫|梅残半点白|猿叫一声孤
五月逢重五|堂前共举觞|无端小儿女|争索五丝囊
结庐向南山|日夕入佳气|岂不淹岁年|地远心所慰
骡马缘风热|因此作你黄|涂药教驹匝|切恐结成囊
池鸟夜喧寂|水屋月流明|坐深清景迈|不知莲露盈
宿食共相投|枯荷野渚秋|平生急难意|何用急时求
明月一樽酒|清风万卷书|南山山下地|终欲卜邻居
秋容何处佳|淡泊寄寒水|无滓湛遥天|我心正如此
朝看长白山|暮看长白山|山色有朝暮|吾心常自闲
饱食无馀事|逍遥散步行|清晖人不见|鸥鹭自相迎
闭门春雨后|芳草上阶生|讵知严霜月|聊复一时荣
夏雨涨黄流|夜鸣邻船柁|乘危冒险人|不识西山饿
燕舞起香尘|莺歌出绛唇|直须灭银烛|恐有绝缨人
尘鞅苦相聒|江槎喜自闲|数编翻欲遍|小饮卧看山
借筹渭阳幕|边画分毫毛|邵州二千里|能勿鉴寐劳
开轩面杉竹|冷翠摇清空|披衣水边石|长夏来薰风
鬼谷岩前石|唐文字字奇|何当拂苍藓|细读老君碑
社鼓村村急|春流岸岸高|双分待鱼鹭|红认隔溪桃
青虬在其上|雌霓甘为下|游者虽异途|阴晴不相舍
不忍身逃箭|知为母塞疮|人心有如此|兽面本何尝
山静无人声|焚香坐朝暮|苍藓盈阶除|落花遍庭户
风翻朱里幕|雨冷通中枕|耿耿背斜灯|秋床一人寝
云端发清磬|松里耿疏灯|欲识心中事|还应出世僧
岸帻坐微凉|荷池雨新足|永夜寂无人|流萤度深竹
低处最多情|声迟拍转停|坐中肠亦断|况乃隔帘听
结楼依东城|楼高凌睥睨|吾欲览大荒|浮云莽不止
饭煮忆青泥|羹炊思碧涧|无路献君门|对案增三叹
越溪与文溪|昔日大名齐|文越不同道|溪流分悟迷
小玉探春回|褰帘笑语来|今朝庭树上|忽有数花开
片雨过孤村|晚溪晴洗马|复有如花人|浣纱明月下
未必黄明在|终令丑口亡|难教疏网漏|不直败毡藏
东洞火痕多|温柔如水玉|秀色生文姿|为君日三浴
御榜揭红墙|春风马上郎|特引双蝴蝶|来荣插帽芳
春雨暗西池|轻寒袭罗幕|愁倚小屏风|墙头杏花落
雷雨过前溪|竹色犹黯惨|泥中有龙孙|戢戢露头颔
人事无如何|多于道傍草|但问酒有无|莫管老不老
煖坐无寒涕|窗油雪让明|地炉糠火熟|饱听乱松声
荣枯观物理|万事总如斯|无虑复何遣|惟吟靖节诗
乍面成乍煦|易诺旋易悔|孰与少踟蹰|犹令直道在
巉石横岸曲|碧叶生秋树|朝朝欸乃声|不识江中路
宁复露棱角|明心不受欺|千年谁可转|空照是宗师
踊跃谷生风|峥嵘百兽中|岂知王者瑞|足不履生虫
丹灶功成后|寥寥掩竹扉|但闻蝉已蜕|不见鹤来归
上士体虚无|瓶泉与道俱|倘馀涓滴润|可救众焦枯
朝凿西山石|暮填东海水|西山石可尽|海水浩无底
如何百城内|一一画元方|劝孝贤刺史|观风职所当
膴膴川原合|依依桑柘疏|柳汀与花坞|好是辋川居
重叠四百峰|铁桥在何处|莫将别驾来|同到飞云去
招提临古道|窣堵压孤山|十里梅花树|都来一望间
春至百卉萌|日出万象丽|不应拈破时|别自一天地
流水绕孤松|清风动疏竹|俗客不到门|莓苔长新绿
眉淡凭谁画|床空只独居|天涯音信绝|还寄梦中书
水浸石根冷|风吹藤叶飞|菰蒲秋影里|长趁钓船归
浮香绕曲岸|圆影覆华池|常恐秋风早|飘零君不知
有意濯尘缨|河流伴客行|翻嫌河畔水|不似石泉清
雨云冒山头|晴云出坞口|东峰有龙湫|雨我私百亩
团扇复团扇|团扇亦已好|但恐秋风至|弃捐在中道
广成住崆峒|庚桑居畏垒|一鞭山色中|吾道无成毁
愁倚溪楼望|还因见月明|月明如有约|偏照别离情
清波滔碧天|乌藏黯黮连|二仪不辨处|忽吐清光圆
旧梦在何处|新梦续相从|旧空那可续|新续总成空
东西填脚债|已过一秋期|今日拈花处|思君第一卮
陇上春风生|江梅几枝发|仙人坐吹箫|飞堕一楼月
偶随流水出|闲趁白云归|步石苔侵屐|攀松露滴衣
曲径穿丛密|香清为客来|玉梢梢外雪|苔古晕疏梅
悠然四松顶|置此六尺斋|事事张功父|何论十二钗
皇猷被寰宇|端扆属元辰|九重丽天邑|千门临上春
位逼将求说|书来欲铸颜|柰何化鹤去|不见珥貂还
飒飒树头风|山犬吠不已|呼童启柴扉|明月照溪水
河上牛郎立|桥边织女过|一时才相遇|两意自谐和
叶落满庭阴|朱门试院深|昔年辛苦地|今日负前心
苍竹纬琅玕|为形有如豆|遇祭何所容|乾桃与脩糗
高阁倚天碧|湛然明镜中|了知身是幻|寄傲在虚空
蒙茸冒枯几|想像挂霜枝|永失金衣友|文章安用为
尝评节物佳|无出九日上|岂独为黄花|端由有元亮
厌世逃名者|谁能荅姓名|曾闻王乐否|眷取路傍情
一自分携后|吟怀转寂寥|小窗孤烛夜|忍听雨潇潇
棐几坐永日|岩花动微风|未知堂中人|此乐谁与同
路左孤坟在|何方示化身|惟留桥上月|长渡往来人
走却坐禅客|移将不动尊|世间颠倒事|八万四千门
望君水轩西|恨杀前村树|日暮溪雨来|扁舟在何处
射鸟还来凤|君王总不知|承恩看合德|玉面发赪时
粉箨解香苞|新梢展凤毛|空庭明月夜|只怪粉墙高
情弱抽思长|腕娇运笔拙|口诵恐易忘|笺书还自裂
吾家数兄弟|薄有古人风|生计何曾足|酒杯无日空
重复青山里|双峰锁寺门|楼耸排云阁|松盘过路根
百雉云中午|双虹水面晴|曲江春事蚤|随处丽人行
岂是无仙骨|平生百念轻|但存方寸地|吾不计前程
马上谁家子|相逢灞水头|片言合义气|笑赠千金裘
维汉南有箕|垂象列三辰|长司簸扬职|糠秕居前尘
日日思前路|朝朝别主人|行行山水上|处处鸟啼新
意妾似花枝|愿与春长在|郎意似花阴|逐日阴移改
乱石倚巉岩|山径故崎岖|肩舆度前冈|松风吹我衣
一病三旬久|脾衰秋气侵|谁怜形影瘦|犹喜月相寻
青云覆叠𪩘|白鸟度平湖|钓屿夜来雨|山深知有无
独坐掩罗帏|愁看双燕飞|思君不如燕|一岁一来归
箫鼓修雩祭|风雷起古湫|虽无豢龙氏|尚有斩蛟侯
山中春已晚|处处见花稀|明日来应尽|林间宿不归
渺渺太湖水|湖中多鲤鱼|故人时把钓|应有北来书
秦淮临别处|月落早潮平|离思如潮水|相随到吕城
幽石生芙蓉|百花惭美色|远笑越溪女|闻芳不可识
小院藏修竹|柴门傍曲江|系舟杨柳岸|诗句落僧窗
酒兴唯诗赖|诗怀实酒因|高吟到佳处|满酌岸清巾
自是太古人|一身衣百草|年年只在山|怜尔亦枯槁
山色重拈出|秋云似削平|可怜松下路|月黑不堪行
客归青海头|报道单于死|晓起望征人|新妆从此理
短棹经行处|风披藻荇香|中宵孤鹤唳|片月在沧浪
倾盖见芳姿|晴天琼树枝|连城犹隐石|唯有卞和知
肇履璿玑历|重飞缇室灰|寒随土牛尽|暖应斗车回
好勇能过我|当仁岂让师|勇须仁以济|仁必勇为资
竹阁公所爱|延僧酌夜茶|渔歌天外起|何似听琵琶
号令行惟信|人谁不我承|举烽诸国叛|敲铁小童应
已分几上肉|谁藏腹下刀|安知羊不死|乃复自羊羔
居独念无僻|境动情不肆|圣人然后能|学者须敬忌
民愚一何鼠|民怒一何虎|谨毋芟刈之|持以报九五
逆旅程难进|疲肩重日增|归期无用数|俛首事孤征
客来借毡看|笑指一书策|不管卖不行|且图偷不得
昌国古要区|人物屹相望|功名刻高崖|粟帛赐满箱
一干生数花|春风折香玉|持之赠所思|幽人在空谷
清琴久无声|芳佩邈已解|疏影落斜阳|萧萧复谁采
茅屋深湾里|钓船横竹门|经营衣食外|犹得弄儿孙
水殿笙歌歇|宫门听漏签|薰风吹藕荡|香度水晶帘
柳眼青迎客|禽心乐傍人|鹤须为起舞|童侍亦相亲
故园兄与弟|一别又经秋|昨夜相思梦|分明到广州
南枝春意动|林杪散朝暾|无使传芳讯|看花日又昏
花早春何力|香寒晓尽吹|月摇横水影|雪带入瓶枝
家临九江水|来去九江侧|同是长干人|生小不相识
山城一夜雨|客意巳深秋|况对临湖寺|千松翠欲流
郑虔骨已朽|孔父天不遗|他年从事贤|手板空倒持
霞口镂衢鞍|霜蹄削玉寒|晓看经逻些|暮已蓦楼兰
当时饿鸱箭|惊皇无复魂|困卧阶下草|深愧主人恩
天上会双星|桥渡银河水|一别动经年|楂楂徒报喜
涧底云根湿|林稍风叶鸣|何时明月夜|来此听秋声
群木上参天|清阴并为一|炎曦无路来|不废风月入
乱石托孤根|群槎避清芬|空山人不到|花照玉晨君
空房心胆怯|灯影半将残|揽衣频起剔|扬彩伴更阑
在处飘红雨|临窗照夕阳|何时清禁里|一笑伴仙郎
只见漫天雪|元来亦有花|两三花自好|半树太多些
草木何丰彤|悬崖护丹穴|相传通鼎湖|深窈吹寒冽
寒山远欲无|春在冥濛处|何如扫浮阴|尽放岧峣露
服食求神仙|何如孤竹子|一食西山薇|万古当不死
双流决决鸣|石根失其一|弃糠于此中|应从玉泉出
白鹭白如雪|照影临沙碛|翻被鱼先见|终日不得食
倚杖临寒水|披襟立晚风|相逢数君子|为我说濂翁
滴滴出石间|初疑松上露|点易日有程|还应周天度
含悲吊屈平|壮心怀马援|香芷生沧洲|铜柱倚荒甸
昔游西太乙|今日返成都|若问去来事|云藏月影孤
十载脾神厄|何曾食有鱼|击鲜徒溷汝|遗鲊适忧吾
夕英色衰落|小摘尚盈襟|错会离骚意|元无满地金
鹰吊横绦路|春风动客衣|浩歌登绝顶|回首万山低
焚香坐蒲团|神定心更逸|坡翁有嘉言|一日便两日
日月岩前鸟|秋来不复闻|达人今已化|名系此山云
坐对蒹葭晚|遥悲水国秋|鱼书长不达|江上怨阳侯
借问金沙地|何年玉髓开|水寻沧海去|云抱碧山来
草树随方别|枫亭故有枫|故乡乌臼树|霜色更深红
大地寒深处|参师不自知|青天还日出|一路见来时
秋云轻似叶|秋叶复如何|日日溪头坐|飘红几许多
騋牝三千匹|云屯十二闲|六飞当御驾|喜色见龙颜
归来遽云出|既出又归来|自处苟如此|渊明安在哉
晴即前岫樵|峰分方未返|路乱笼绿罗|云晕涌愈远
风静云归山|风起云作雨|伛偻久无心|日倚亭前树
扁舟横薄莫|渺渺蓼知秋|家山有江湖|何必赋远游
君王全盛日|宫殿此沈沈|歌舞无人见|唯馀钟梵音
五马来何暮|经营指一弹|石碑书近事|留与后人看
山势连天合|溪流过峡分|难将一溪雨|写出两峰云
老丑慵看镜|清狂爱作诗|唱酬真得侣|衰白亦相宜
寥阳龙已化|华表鹤空悲|欲问梁朝事|惟应老桧知
心寄羲皇上|生逢晋宋时|风流千古意|只有杜鹃知
登览多清兴|衣襟有白云|松风不知际|仙籁坐中闻
御柳依然绿|宫苔取次生|黄鹂深处语|不似旧时声
涛涌雪成滩|星石绾其口|谁来选渔竿|约此溪中友
无田艰岁计|有子不为贫|藿食恒余味|蓬门也自春
风来莫乱吹|摇我庭中树|树上有鸟栖|惊飞无住处
采芳复采芳|采之何太勤|芳馨塞天地|吾自美灵根
烟势分岚出|波痕映林薄|兀坐不逢人|邻花相对落
城市何年别|烟霞尽日闲|松潭明月上|把钓不知还
密粟出浓紫|幽花间深黄|有谁吟其间|含香一薇郎
维舟汉江滨|水色照黄鹤|骢马何不来|风雨横江落
露气集芳丛|千头趁晚风|淡妆宜小摘|鬓亸玉玲珑
每岁听蝉处|那将此际同|孤村寒色里|野店夕阳中
半山字说行|精义极贯穿|世好鸦蚓书|谁识虫鱼篆
东井回天地|西奎应古今|已无生与死|况复说浮沉
唐皇溺太真|爱心苦未足|因人忆海棠|何如悟秉烛
天地亦已大|斯人何苦心|把酒语不得|西风吹上林
尔向沧江别|予方湘水行|秋风莫相负|迟尔岳阳城
镜湖中有月|处士后无人|荻笋抽高节|鲈鱼跃老鳞
道本无垢净|境自有喧寂|愿闻禅说中|何以得真实
闻君新酒熟|况值菊花秋|莫怪平生志|图销尽日愁
郡斋谁种竹|绿荫未多浓|我欲添清閟|殷勤护箨龙
野水漫凫汀|烟芜接远坰|数峰青抹黛|遥指不知名
百步洪头水|秋霖一夜浑|相携濯缨处|无复履綦痕
何事不驱蚊|癯然床下身|伤肤非所惧|所惧去伤亲
山僧赠衲衣|旧是稻田样|石床不解眠|夜礼天坛上
何由芰制衣|岂必兰为佩|一笠一蓑轻|田渔且相对
循壁渡泉桥|知有幽人宅|山气动□馡|香獐夜来迹
秋晚不扃扉|秋亭一叶飞|采莲人不见|水面落红衣
一水明两岸|千峰长绿苔|凭高窥鸟道|寻胜得鱼台
沙砾喧寒雨|枫根挽钓楂|菰蒲起烟火|隔水是渔家
觱沸一溪泉|巃嵷千古木|中有避世人|阴厓结茅屋
叶如花傍砌|往事逐浮华|旧曲惟传恨|人间复见花
什袭发硎刀|无名自贵高|秋衣犹葛制|午饭厌溪毛
天性生虽具|人伦教可无|往哉亲父子|汝契作司徒
明月皎如银|中有丹桂影|怀人坐良宵|衣裳露华冷
何年金粟树|留客怜樛枝|淮南招可隐|一咏小山词
关河霜雪清|故人亦流落|夷歌奉玉盘|悲君随燕雀
壶中冰始结|盘上露初圆|何意瑶池雪|欲夺鹤毛鲜
乐在知几早|忧因见道迟|遥怜鲍庄子|人笑不如葵
元祐赋律古|熙宁经义新|请君忙改艺|诗好误终身
子美食樱桃|题诗叹转蓬|空怜点唇绛|尽作滴阶红
或言严本庄|蒙庄之后者|或言汉梅福|君之妻父也
远山俯可拾|北斗近堪凭|共在白云里|君居第一层
彼已苦其密|此犹患其疏|欢呼试新网|一举双白鱼
二阁宁独暖|万家方号寒|何当放春去|和气满人间
师者人之范|辨惑正吾疑|苟不就有道|伥伥其何之
臣繇贺捷表|臣结中兴碑|亘古雄辞在|于今老学谁
溪上娟娟竹|年深百尺馀|何时过溪上|折竿钓溪鱼
南垞与北垞|岸远渺难即|此处好行舟|面面芙蓉色
松暗水涓涓|夜凉人未眠|西峰月犹在|遥忆草堂前
穷通皆有命|守道竟何惭|莫计荣枯事|逢人尽醉酣
新霁洛城端|千家积雪寒|未收清禁色|偏向上阳残
见尔芙蓉沜|点水款款飞|黄头棹船去|半湿轻罗衣
竹径转西麓|山花能白红|要知造物心|政在无言中
雕锦剪花团|三边总认看|寻常不肯着|风雪念兵寒
饱去樱桃重|饥来柳絮轻|但知离此去|不用问前程
微雨逗芳华|悠然动百花|岭南春事早|梅李竞交芽
坐久香不断|开残花尚奇|林莺知客意|一啭似笙诗
种葵如种麦|隔岁已下子|仅成一干花|浪备四时气
幽幽涧底兰|花叶愁枯槁|不及尔青蒿|春阳能得早
万岁菖蒲酒|千金琥珀杯|年年行乐处|新月挂池台
风交蒲苇乱|烟断凫鹜飞|日暮一笛起|扁舟垂钓归
堂上会亲戚|可怜马上郎|呻吟更流血|干戈浩茫茫
流水弯还来|羽觞酬酢竞|应有兰亭篇|邦人起歌咏
送远翻清调|山高水更流|子期欣共席|黄醴满金瓯
夜久喧暂息|池台惟月明|无因驻清景|日出事还生
入室五千卷|插架三万轴|何似晒书人|坦此便便腹
谁来蹑高步|幽径已荒凉|落叶无人扫|哀猿空断肠
杂卉烂春色|孤峰积雨痕|譬若古贞士|终身伴菜根
持宪使荆南|咨诹驰六辔|鹰隼不及凤|愿勿失此意
试问窗前竹|栖鸾会有期|丁宁休剪伐|留取拂云枝
千百年之间|辋川图若见|不到文杏亭|那识王维面
莫问苍梧远|而今世路难|胡尘不到处|即是小长安
日午尚高眠|问人雪霁未|沙弥九岁馀|不识人间事
琴书四十年|几作山中客|一日茅栋成|居然我泉石
望远吴天雁|情深谷口阴|扁舟殊自滞|还负子猷心
八骏去已久|骅骝未易逢|君看七十匹|若个是真龙
挂席东南行|青山望迢忽|日暮寒潮生|维舟对孤月
大道元无定|如何说觉今|须知觉了后|不减原初心
实德吾应愧|浮名信所遭|未能忘厌羡|祇觉一生劳
白浪高如屋|停舟日已中|长芦望不到|愁杀石尤风
幽鸟噪岩谷|寒烟锁薜萝|忽遇金蟾蜍|无人自呵呵
山脉贯龙腹|山髓出龙口|九道下成池|千年溉灵囿
亲见房太守|殷勤奉旨甘|那能不心愧|岂止是颜惭
隔松闻桂杵|玉粒捣玄霜|水月明笙鹤|江云冷石堂
东风吹暖气|消散入晴天|渐变池塘色|欲生杨柳烟
世间猫捕鼠|谁知鼠捕猫|会得个中意|何须面壁劳
物外山川近|晴初景霭新|芳郊花柳遍|何处不宜春
胡越同心日|夫妻反目时|人间无大小|得失在须斯
陇头人未来|江南春几许|惆怅玉箫声|吹落胭脂雨
不待东风拆|池塘已自春|试看源上客|犹恐是秦人
千金募战士|万里筑长城|何时青冢月|却照汉家营
绰约敝姑射|倏忽归鸿濛|谁云橘中乐|不减商山翁
老翠山皆洞|深红树颇花|人夸仙世界|我笑是贫家
莫即叹飞蓬|醇醪更养蒙|秋花应似汝|老作雁来红
桂楫寒烟浦|茅庐老树枝|画图嗟岁暮|不及见春时
同住长乾陌|经年来往稀|采莲相借问|并着画船归
雪重玻璃捲|苍然色不渝|苦辛通性窍|登荐后甘腴
赠子槟榔花|杂以相思叶|二物合成甘|有如郎与妾
土俗诸蛮异|人心一理同|古今鸡犬月|南北马牛风
采菱须采早|菱老刺侬手|刺手不足忧|菱老如侬丑
不惜将黄金|争头买颜色|妾貌自可恃|谁能苦劳力
月在潭水中|水清月儿白|风来莫吹动|天壤吁一色
虽得苏方木|犹贪玳瑁皮|怀胎十个月|生下昆仑儿
湖边法喜楼|千顷冷涵秋|吟绕维摩室|风生杜若洲
倚杖看明月|停杯唱竹枝|美人期不至|对景立多时
山下无人踪|山上无鸟语|惟馀一片云|见我来游此
金刀剪紫绒|与郎作轻履|愿化双仙凫|飞来入闺里
作客翻为主|殷勤送所亲|不知为客苦|试看南归人
斜阳照石壁|寒泉浸松影|风生万籁虚|鹤唳千山静
桃李寂无言|垂杨照溪绿|不见苎萝人|空吟若邪曲
慈悲乳孙叔|恭敬侍小颠|烦君常警逻|老子□□□
越公多美妓|卫尉足名姝|无计留红拂|伤心坠绿珠
楼台出林杪|入望杳难分|半夜投龙去|千山尽白云
水国春已生|微波漾洲渚|时见挑菜人|临风自凝伫
公非不通险|任重载者浅|此去荷责轻|又得先归便
杨柳馀朽株|梧桐但疏阴|小卧不出门|不知秋已深
明月落谁家|信是无心得|出门舞婆娑|梨花满庭白
客途过半夏|榕圃正当归|欲附子音信|天南星使稀
忆昔杜陵老|恨无千万间|君能恢大义|吾党悉欢颜
尘海东南下|云山西北高|黄流荡中潏|万里费波涛
相别亦何事|相逢尽偶然|愁肠贯彩笔|离梦绕朱弦
小小储金鲤|池波一镜平|不须桃浪暖|头角亦峥嵘
晚云横树薄|寒雨入帘微|川净鱼堪数|人间鹭不飞
君家湖北头|门前湖水流|水流似侬意|日夜不曾休
来说湖西者|不及华山顶|谁知岩中仙|解作石柱屏
西施颦自好|邻女未全非|但使怜颦得|毋须吴苑妃
江皋草已长|微飙吹绿漪|物情本自适|偏入少陵诗
锦架丝绦旧|羁縻气转雄|草间狐兔尽|饱食待秋风
蕉闻王子晋|云卧夜吹笙|控鹤冲天去|松风千古声
项上如生旋|有之不用夸|环缘不利长|所以号螣蛇
昔为避世乡|今是朝宗路|桃花春水间|犹是寻源误
槟榔自无柯|椰叶自无阴|常羡庭边竹|生笋高于林
去岁望云心|东归车马疾|君今向故园|非复倚门日
树暗春将老|酒阑人欲归|裴佪风月夜|花絮一帘飞
绕涧绿猗猗|秋风吹紫蕤|如何生杜若|浑欲杂江蓠
江树风力斜|江波雨声急|孤篷有归渔|清寒压蓑笠
落落罗浮松|皎皎耶溪月|将月挂松端|清辉两寥泬
杀身明逆顺|濡足救危亡|未必荀文若|甘为操子房
断碣馀苍藓|高文记赤乌|浦深春水阔|天远野云孤
阳生在十月|亥谓之天门|战乎乾者物|乾实战于坤
皂隶百轻肥|金朱弹丸箧|君方踞胡床|风掀缃册叶
野菊日烂漫|秋风随分开|寒香与晚色|消受掌中杯
去骖嘶别路|归棹隐寒洲|江皋木叶下|应想故城秋
秋老泽国寒|稻粱资啄食|岂不怀同心|天高整孤翼
尔作为文章|文章不利尔|大都机事人|毕竟机心累
落此鼪鼯野|宜从麋鹿群|何知交友内|而乃得夫君
危石江中起|孤云岭上还|相逢皆得意|何处是乡关
盛世须材杰|高名动圣明|一麾淮海去|青旆拥千兵
我欲游京口|浮家未有船|羡君无一物|篷底曲肱眠
槐柳拂云长|清阴覆短墙|群芳俱落尽|祗有菜花黄
官样何如野|谋生拙最宜|君门标野拙|篆刻大精奇
庶草将蕃庑|群阴自退消|迟迟杏梁日|长照紫宸朝
山开稍有路|水放亦成川|游人得所息|真意方澹然
剪彩宜春胜|泥金祝寿幡|雪梅同雪鬓|相对两凌寒
金梭抛翠丝|东风弄晴昼|求友不须鸣|绿窗人倦绣
物理窥开后|人情照破休|止堪初看望|不可久延留
千年白鹿地|今有佛楼台|昨日到山下|衔花犹出来
竹不愧老可|人今无老坡|聊将一卮酒|相与酹苹波
小浦闻鱼跃|横林待鹤归|闲云不成雨|故傍碧山飞
绿净不可唾|此语足千古|天水澹相涵|中有数声橹
自谒上元归|不作向平想|俨然病维摩|阿閦在手掌
不独山头白|人头亦垂素|积雪有时消|青山色如故
怀归空有感|包贡则无因|跳入商山去|添予作五人
插屋数竿网|穿篱几尺船|水乡菱芡足|不著免租钱
相唤檐前度|嘤嘤柳外莺|寒衣裁未就|忽断剪刀声
山中清且闲|寒雪共朝夕|除却自行踪|并无麋鹿迹
融香一尺云|煖玉三竿渚|不知濯锦波|唤作桃花雨
碧落秋方静|腾空力尚微|清风如可托|终共白云飞
怪石从何得|玲珑自可怜|感君同白璧|置我小窗前
秋水一抹碧|残霞几缕红|水云霞尽处|隐隐两三峰
赤壁不改色|汉江依旧流|二龙争战后|风月属扁舟
长沙游玩地|多有墨工奇|旧说胡光烈|今夸郑子仪
盥面知新瘦|看书觉近昏|风霜不相贷|老意与谁论
叠嶂最惊目|排青隐星络|双溪颇醒心|激素出林薄
塞北兵戈满|竹西歌吹空|何堪故乡梦|真在白头中
水獭荷花下|鹭鸶荷叶边|渔舟更数罟|谁为小鱼怜
迢迢还乡路|程程日逐西|鸡鸣时问境|十里是金溪
危栋势凌空|时有浮云度|应与楼中僧|去来本无住
舟中采莲女|两两催妆梳|闻早渡江去|日高来起居
海日高低影|风舟远近程|利名刚两字|云水一虚亭
仰极摅忠荩|临民薄赋徭|我来君已逝|凄切夜蛩号
灰里拨阴何|思君欲就哦|还忧好时节|来搅或遭呵
冰玉有馀映|铅华暂谢却|安得素心人|徘徊弄春爵
歌伎悬灯引|材官导马归|更移花下席|取次换寒衣
新篁故蒙丛|恶草刚荟翳|删薙似少恩|成渠玉无际
兴庆坊前柳|萧郎手自栽|藏鸦今渐稳|只是不归来
入用因埏埴|时行任比方|连阶□□□|□□□□□
此骏产渥洼|神奇莫浪夸|相期千里志|赠子字无邪
归来一杯酒|聊慰九泉下|秋深有良贾|拟报连城价
别酒故人同|留诗古寺中|唯应湖上竹|一为起清风
愁来不成梦|梦回心耿耿|定力嗟学微|长夜谁予警
帆影宵仍远|山容午始开|水禽无意绪|飞去又飞来
晚岁习禅寂|已无世上情|如何深夜里|犹自感秋声
凉月光不了|照我芳桂丛|白凫如人长|来往柴门东
寂寞东篱下|幽花裛露黄|自缘寒节至|不是爱秋霜
春江波自绿|不染木兰舟|只与岸边草|依依添客愁
问尔看山人|山中坐几春|定知方寸里|无处着纤尘
别作一家春|故畹已禾黍|黄香从何来|谁为东风主
四月沙河市|青盆雪色盐|吴儿甘美饫|可是喜酸咸
为问马上郎|墙高复几许|海青不上天|那得天鹅去
适意步回廊|长吟看修竹|商飙何处来|吹堕半窗绿
夏日山房清|田作稍就次|衔杯自有真|高枕元吾事
月照马驮山|秋气清人骨|马驮驮不去|千古一轮月
土鼓供儿戏|林泉多珍味|风物自依然|流光换人世
南雪不到地|著树斗琼花|正是可怜色|儿童休打鸦
生当为人杰|死亦作鬼雄|至今思项羽|不肯过江东
智者有所说|后生谁究明|韦编具此眼|时止复时行
去年留不住|年来也任他|当垆一榼酒|争奈两年何
茨菰栽半亩|生水引官河|表以慈姑号|因他乳子多
舒徐春昼永|取次小桃红|独爵把枝稳|矜呼立晚风
躧步凌高台|景气非一状|明月本团圆|不为山河障
何处窥刚德|应于众聒时|初心原不恶|底事为人移
獬豸霜中貌|龙钟病后颜|惨伤此身事|风雪动江山
此日天中节|它年赤伏符|只因昭火德|不为记荆吴
乌风起肝脏|忽患便青盲|便是通神妙|除非解损睛
噫声初发窍|巨浸倏漫空|我欲镌箕毕|为天节雨风
涕泪昨辞亲|酸心今别子|舟陆空相望|掺袂即千里
落日沉大堤|湖上归舟少|遥遥望村居|浩歌水云渺
子尚乃如许|壮年坟已荒|我来亲种柏|含泪待苍苍
一琴三尺剑|舣棹北溪滨|莫是玉溪子|迢迢访故人
梦亲在三更|忽醒仍万里|不是好飘蓬|此乃平生志
江南二三月|大地皆阳春|万花最深处|中有读书人
阊阖城南夜|澄鲜一望中|可怜台上路|举步是蟾宫
曲曲通航小|兰桡手自移|映丛怜白鹭|特地过湾迟
溺天子殿衙|呕丞相车茵|古有礼揖客|今无劾弄臣
物理窥开后|人情照破时|可嗟兼可唾|堪鄙又堪嗤
池上一峰孤|下瞰池亭小|书空兆人文|卓笔青未了
相逢三岛客|东海又沧田|不记辽东鹤|归来近几年
区区乘传客|得似贾胡留|我亦黄埃底|空惭鲈鲙秋
楼迥衔空雾|郊长占暝霏|戏鱼晴自掷|寒鸭夜还飞
清溪照眉发|棹举扬清波|何当结茅屋|时与神仙过
玉腕指尖新|力能提万钧|上他篮子里|未必是金鳞
玉烛天时正|金穰岁兆丰|华封遥上祝|圣德与天通
不惜玉交枝|劝君金叵罗|君恩别处新|贱妾当如何
烟低一片春|留与贫受用|阿连自能诗|吾衰不复梦
三宫催解粽|妆罢未天明|便面天题字|歌头御赐名
津头晚风急|攲倒一丛芦|宿雁逢清泚|飞来作画图
柳絮觉春归|轻盈著处飞|东风好收拾|莫遣坠征衣
朝看亭上山|暮看亭上山|问君心何似|白云相与闲
皎皎映澄漪|千寻没到时|篙师轻转橹|可惜碧琉璃
今宵何处泊|七十二峰前|记得夜来月|江心五度圆
艾叶成人后|榴花结子初|江心新得镜|龙瑞护仙居
昨逢山寺中|今送清溪口|山水无别颜|行人自分手
花落春无语|春归鸟自啼|多情是蜂蝶|飞过粉墙西
霁雪东西崦|寒云上下沙|何人吹玉笛|早有落梅花
危山耸如人|绝壑下如阱|居然垂钓翁|相呼不相应
金为□书掷|门因远俗扃|春风何处入|庭草夜来青
门前春水滑|柳外夕阳斜|欲识春风面|满城桃李花
修证彼何人|有国号众香|此境了不殊|沉檀蔼飞扬
曾荅雁门偈|为怜同社人|多惭惠休句|偕得此阳春
忽破苔痕去|微微屐齿馀|落花真妒尔|片片在裙裾
雁影江潭底|秋声浦溆间|吴儿歌一曲|月子几回弯
别借金刚窟|微分室利场|羞他石卫尉|火宅号清凉
玄微达造化|得一不言三|利益众生愿|情迷谩口谈
天不雨霜雪|朝曦与暮霞|江梅呈腊蕊|岩桂又冬花
漏恩馀草木|苛敛察箕头|犹有形骸碍|谁为根本忧
真主乘昌运|假王恢隽功|如何亡赖子|失笑未央宫
不得长相守|青春夭蕣华|旧游今永已|泉路却为家
渡头人眼众|船开不敢要|惯知侬泊处|不过西泠桥
外物虽无累|诚心每在民|薰风能解愠|亦足助尧仁
忆我山中竹|长身立崖谷|势重且抢头|谁欤摇蔌蔌
嘱付池中水|长依高士眠|莫贪沧海阔|转眼变桑田
羽翼汉家了|忘形天地间|个中有真乐|奚必拘商山
咫尺愁风雨|匡庐不可登|秖疑云雾窟|犹有六朝僧
染丝上春机|春浓丝色浅|妾心随梭飞|郎心如轴转
庐山涧底泉|处处鸣寒玉|惟有黄龙潭|龙兴沛膏泽
王公轻以道|富贵骄以志|我见高尚人|盖有高尚事
不肯竞桃李|甘心同艾蒿|德人一题品|愈觉风味高
高阁霞为幔|参差花影重|斗间真气在|知有抱珠龙
芙蓉出秋水|盈盈好颜色|欲采无轻舟|夕阳空伫立
寻源怅何之|渺渺入荒野|裴回灌莽中|偶尔遇樵者
疑著风波恶|民谣亦畏人|筑塘成堰后|斩马祭河神
莲白多生花|莲红多生子|采白莫采红|留红在叶底
岁寒群动息|惊见早梅新|一夕冲冰雪|春光漏与人
老屋如巢居|亦复御风雨|中有独坐人|焉知不可语
不见同心人|相思渺云树|记得别离时|却在云飞处
南浦江波绿|阳关柳色青|夕阳千古恨|分付短长亭
渔人将楚竹|吹向月明中|莫奏凉州曲|金河有断鸿
一烬城门火|馀灰已复寒|小儿争炙手|犹作燎原看
饭罢匆匆别|劳生可奈何|不能留一宿|有愧此峰多
云门出孤月|秋色坐苍涛|夜久群籁绝|独照宫锦袍
黄落献晚山|枫林有馀景|携鹤上渔舟|布袍弄江影
覆堤初冉冉|渡水尚迟迟|一树梨花色|犹能似旧时
舍肉增长叹|分甘助浅斟|赠君椒柏酒|慰我蓼莪心
汝壳将自遮|汝肠还自刳|可怜一底板|虽智不如愚
一自怜捐弃|香迹玉阶疏|闻道西宫路|近亦绝鸾舆
萧萧琴瑟鸣|洒洒霜露下|愿期素心人|同游明月夜
越国无双艳|吴宫未始知|谁言勾践黠|不自爱西施
云净月华明|江山各自清|道人垂首坐|莫是听松声
毕弋横前路|江湖寄此身|平沙下双雁|不见问津人
窗烛泠残夜|闻蛩更闻雨|秋馆总多愁|犹胜在羁旅
岁落众芳歇|秋来百草生|万重关塞断|慷慨泪沾缨
书消燕日长|棋遣花院寂|何羡山中人|餐霞拾橡实
舜提归□□|□□□□梁|束手无争执|应惭此玺郎
急霰透疏棂|寒声杂鸣柝|被冷不成眠|夜永愁偏觉
妾在山中来|郎在溪头住|郎若泛舟寻|莫误桃源路
野色山千里|香风水半池|小亭无一事|白日苦催诗
徘徊复徘徊|几度孤城暮|不见远人来|望断南桥路
萧萧三五花|影落寒溪浅|佳处不在多|诗兴孤山远
兰气浮丹殿|槐阴被紫宸|薰琴多在御|挥拂寄深仁
睡起无一事|怡然盼庭柯|绿阴微缺处|最得南飔多
猿将朔吹哀|云带溪流驶|相送独归僧|萧萧夕阳寺
参差山接野|渺莽水连空|笠钓沙头客|真宜避世翁
修修稍出类|辞卑不肯丛|有节天容直|无心道与空
展武沈沦后|波澄一鉴明|桑田复更变|触目总柴荆
覆之茅三重|树以不加斲|野息若规模|规模如是作
送君出洞去|信手闭三关|君有阳和约|一阳来复还
醉拥三妇艳|富润十亩宫|独有草玄客|不谒陶朱公
湖阔疑无地|堤长亘若虹|孤舟数点雨|杀却日南风
竹节疗膊疮|骨钻亦难当|若涂先用洗|欲使洗盐汤
双鹤桃根啄|三杯棣萼酬|参差人事异|空忆帝京游
移舟信江风|沿洄不知暮|前村路转遥|系缆桃花渡
云滃雨翻盆|千厓互吐吞|归人愁路窄|切莫近黄昏
一丝生白石|片影落沧波|晓座金鏊背|何曾碍客过
一片三生石|圆公不复来|行人寻古迹|野菊满山开
窗外留书带|阶前卧绿枪|倦来抛素卷|狼藉满金床
𫛩雀小羽翼|幽栖短棘梢|丛坡风日好|不让凤鸾巢
压水云欲堕|吞江虹未收|野人聊自适|吹篴满沧洲
溪作玉膏色|洞如天琢成|倩谁呼白鹿|将我上瑶京
童子请缨日|老夫黄屋来|楼船何自下|麋鹿至今哀
小阁何岧峣|霏岚如动色|杖策问筌蹄|丹梯不可即
天宇净无云|一钩初月新|清光偏有意|先照远游人
初日宜征辔|轻寒怯裌衣|蟹黄经雨润|鸭绿得春肥
醉眠屋庐下|开眼菊花黄|多置三百箧|与花收散香
芳林围石坞|人指薛泾原|此日归真宅|端然识寓言
赤日乱青霞|照我湖中艑|来船时借问|前途水深浅
独坐松堂下|参差静影来|西湖歌吹歇|推却小窗开
天围秋涨阔|山背夕阳孤|岸树晴犹湿|汀烟近却无
伛柳碍行骑|山家少憩时|黑云催上马|不省主人谁
东皋或巾车|西园亦飞盖|以我方古人|两脚大自在
海风轰万雷|黑云驱千浪|心知近鬼神|默坐观情状
致虚本无功|辐辐自一毂|天根念正微|吾以观其复
我登海山巅|群丘眇如芥|客来谈九州|更诘谁小大
移根曾宿雨|舒干渐如铜|试问风霜操|终齐十八公
素心爱云水|此日东南行|笑解尘缨处|沧浪无限清
光境俱亡了|寒潭彻底清|溯流翻巨浪|五十四州惊
三年放逐臣|今复得归去|梦已到南徐|船回正鸣橹
高咏北窗前|匡山俨相向|谁知晞古心|已在羲皇上
高人有真趣|林壑暂栖迟|悠悠经济心|未许巢由知
君家韭溪上|侬家穆溪头|相思不相见|恨随溪水流
造化凿绅维|千岩斗空碧|有时云雨开|残阳落幽石
太虚本无色|止水亦长莹|如何桂轮中|忽有山河影
日暮黑云生|且依龙口住|小舟裙作帆|笑语过湖去
萧然上方境|人稀知地僻|徒闻古仙人|石上有遗迹
今年手自栽|问我何年去|他年我复来|摇落伤人意
每岁逢生日|予心喜复悲|新年六十六|能得几多时
史书良为稹|褒诏却因袁|足使济不朽|何堪逢自言
苦见人间世|思归洞里天|纵令山鸟语|不废野人眠
悒悒复悒悒|愁眠成梦泣|薄暮落花天|高楼面风立
朝逢康王城|暮送大堤口|相对无一言|含凄各分手
四齿不曾退|年已只似驹|但看边畔者|咬得臼还殊
煜煜深林色|青青楚畹风|可怜人不见|收拾束薪中
何不学幼子|笑罢忘其喜|不风犹作波|人称为祸水
抱瑟花阴下|朱弦玉指纤|东风弹不就|明月下前檐
窍石为幽居|虚称鲁输子|三十六洞天|天工定谁始
万法如有功|梦事应存体|但知一月真|宁许堕非是
上有千尺桐|下有千尺井|风吹井上桐|零落井中影
生死镜中像|非面亦非镜|像既无起灭|心岂缠垢净
橙花亦娟娟|照水弄清白|孤香少人知|黄蜂自为客
一水细通潮|帆低屡过桥|阴阴榕影下|渔父不相招
稻色满平畬|侵辰穫东菑|今年春穗熟|幸免寒与饥
利荣无冀想|推挽绝偏私|杳杳高风在|执鞭我愿之
风来万树动|月出半山白|谁家吹笛郎|骑牛过西陌
此日黄花酒|深期酌弟兄|谁知有离别|西望不胜情
原沉向九泉|推死已千年|有水皆争渡|无村不禁烟
一代吕家府|风流重此邦|重来还记取|双户对寒江
峨峨玉城山|地势北龙冈|是中产人物|英杰常相望
长林劳屐齿|植杖解冠衣|觅句题青竹|不知孤鹜飞
老树秋先赤|石桥霜后寒|落霞人影静|图画固应难
一鉴涵虚碧|万象悉其中|重绿浮轻绿|深红闲浅红
柳色暗阊门|霓旌拂晓云|湖边采香罢|就阅水犀军
乐天作草堂|胜绝拟终老|出处不自决|徒为泉石道
浪说无文字|楞伽面壁看|元来有怀挟|一世被粗瞒
秋云久无雨|江燕社犹飞|却笑舟中客|今年未得归
两夕田家宿|主人黄粱熟|燃灯起绕床|徘徊候朝旭
两岸山相似|舟移曲不妨|回看京口尽|落照下丹阳
楼带猿吟迥|庭容鹤舞宽|㬠书因阅画|封药偶和丹
瘦玉薄薄衫|晕灯和月冷|独夜不禁春|梨花碎帘影
雁雁呼其群|饮宿不相放|春至且北归|秋来复南向
万顷湖天碧|一星飞鹭白|此时放怀望|不厌为浮客
谁家游冶郎|日日章台下|多谢杨柳枝|为侬系骢马
道可羲皇上|心惟寥廓间|所以采菊人|悠然见南山
龙跳与虎卧|临池称绝笔|一鹅何足观|羲献从中出
秋到情怀恶|美人天一方|夜深窗转月|梦断角吹霜
仙源深几曲|夹岸桃花开|忽漫逢刘阮|殷勤劝酒杯
暮春淳菜长|半出湘湖水|水浅叶生多|不见茎茎紫
苍茫六合外|渺莽三皇初|近既未必有|远亦未必无
一泉流白玉|万里走黄金|人事有因革|宝源无古今
项似蜻蜓样|毛丁又起班|更兼形色正|打遍世无双
入世蕙兰畹|出户苾刍香|古圣超三有|一具白肝肠
献寿人皆庆|南山复北堂|从今千万日|此日又初长
日暖银塘绿|溪边出浣纱|若耶烟似雨|步步入荷花
叶有苦寒色|山中霜霰多|虽此蒙阳景|移根意如何
六翮何飞扬|含苞翳深树|朝来觅羽人|共跨青鸾去
前辈不可见|古道邈难寻|何时赤松子|相与归山阴
春田雨既足|幽岩云自归|归云无觅处|不共鹤争飞
江北西风高|江南新酒熟|长笛吹梅花|月色满营屋
自参薄伽梵|悔作辟支佛|舍利何足言|劫前一枯骨
杰人千仞壁|卓见亦横中|方识不闻睹|穆然洵圣功
晚泊武昌岸|津亭疏柳风|数株曾手植|好事忆陶公
结舍近沧洲|江山不外求|我来明月夜|更得主人留
支言亦有根|根深不在口|任尔三百缄|根动口自剖
凿破苍苔地|偷他一片天|白云生镜里|明月落阶前
结跏向双峨|濡毫成九畹|袭佩芳馨多|怀人江浦远
园井汲寒绿|当窗煮金屑|应有山僧来|从君泛春雪
雨意初蒸暑|林声巳变禽|兼句断来往|无日罢登临
闻说春醪熟|提壶唤客尝|乾坤一酿瓮|花气百和香
晓看烟林青|暮看雪岭兀|似栽苦狂人|立时摸白发
霜黄上林草|天子欲更衣|六宫齐望幸|红紫漫成围
长安在何许|疑在白日下|徘徊天一隅|华月生新夜
野钵归松下|将亲闻道师|风沙不堪寄|霜笴自相宜
禁籞希临幸|宵衣戒未明|馀闲寓弧矢|劝讲只儒生
心清闻妙香|宴坐旃檀林|坐香元不断|莫作死灰心
名高牛氏品|地接燕儿窠|有客图沉醉|翻嫌石是魔
春来雪有香|片片惹衣裳|么凤殷勤甚|衔来欲点妆
城外望城中|朝来气逾爽|吾心浩然者|入夜还能长
蘤含紫附簇|雪蕴碧铃深|小草存衣被|长人谁此心
万壑溪流合|千峰木叶黄|郎山五千丈|独立见苍苍
林下藐姑射|山中萼绿华|驻颜无别药|一味服丹砂
长干一万家|半是君题壁|欲赠草书歌|惭余非李白
云散雨初收|长空灏气浮|露华笼月色|白苎不胜秋
虚槛列云岫|闲阶响石淙|若添千顷竹|又领渭川封
石屏月如水|石壁云不动|闲中攲枕卧|天地同一梦
云卧东寮夜|寒装北返时|欲留他日迹|素壁更题诗
逆旅相逢处|冥冥花正开|今朝与君醉|不辨越王台
熟醉莲荡风|未赏梅溪胜|踏雪访屏山|今年得乘兴
怒风吹老屋|急雨闹空庭|莫叹林花尽|悬知陇麦青
叶尽枝方满|时时飘素埃|晚风吹未了|疑是野梅开
道远频驰梦|情深只寄书|相逢俱泪下|翻似别离初
露柱声声唤|猢狲绳不断|中下莫知由|上士方堪看
乞以臣骸骨|下从樊濯原|生虽阙亲养|没以报私恩
藻荇遍回塘|芙蕖出清水|红灯迭照映|翠盖相磨倚
星汉纵复斜|风霜凄已切|薄陈君不御|谁知思欲绝
气盖五步内|强秦不可屈|嗟哉丈夫心|空自等俦匹
疋马赴宁川|靡靡行不止|水色与山光|一百二十里
高僧话六朝|焚香共清昼|无数江南山|尽列窗中岫
雅志希三釜|平生擅一丘|归寻赤松约|何必更封留
朝吾一笭箵|夕吾一觳觫|诗肠其殷雷|此事底须卜
西风动妾幕|连宵不下机|殷勤语促织|夫婿未成衣
修竹经霜翠|梅花带雪香|幽禽如有意|相唤对斜阳
扁舟何处来|浩浩剡溪曲|不是雪夜期|松杉满庭绿
同水南风急|兰舟不忍开|临分重把袂|归信几时来
寄语问花人|岁月那能借|尔意怨迟开|侬意怜迟谢
莲洞十日居|便作千年计|独怜未绝扳|与子坐超诣
翠环双凤带|小队五花蹄|十二龙钩卷|梨花烂漫时
珠映千门月|花生四壁春|还因相见处|得倚可怜人
北寻小有洞|是昔轩辕家|何日从夫子|天坛扫落花
野水净无埃|秋痕欲上苔|自缘凉坐久|不为看山来
貌高清入骨|帝里旧临坛|出语经相似|行心佛证安
洪流沉近郭|无梦问玄夷|阶下看蜗篆|依稀似禹碑
隔浦风烟暗|桃花自不迷|壶觞怜小阮|时向竹林携
玉佩响琼楼|天风五月秋|人间正炎热|犹轸圣情忧
泽国有幽人|城中稀复见|曾观论史书|吾党有腼面
霜冷晓星高|群鸦近九霄|禁城钟鼓动|环绕似随朝
追风归似铁|留迹向山深|神力犹诃护|苔痕不敢侵
爱松埋鹤影|背月照寒窗|最是无人处|生憎嘷夜尨
罢钓归来晚|前溪水正深|临桥不敢渡|谁识此翁心
满腹盛何物|累累尽药圆|惟将窗下挂|不向杖头悬
霜雪迷西极|云涛隔阆风|平生会心趣|都在净名中
佳名何拔萃|美誉占游春|三月来禽媚|嬉娱异众伦
立朝绍兴间|犹及见诸老|魂梦不可逢|丘坟闭秋草
功名不垂世|富贵但堪伤|底事杜陵老|时时矜省郎
萍实祗如斗|练江都熨开|水清当自鉴|无为濯缨来
朱丝徽黄金|问子用此何|从来履霜操|不及懊侬歌
片月出幽林|闲情欲不禁|天寒怜翠袖|为赋白头吟
诸父纡组绶|翁媪被封爵|盛年得逢此|光耀殊不恶
深闺逢七夕|独拜星月前|但愿无离别|今岁又明年
□□□夜里|折箭传黄旗|野老心无事|闻之忽皱眉
圣德乾坤大|皇图日月长|远人咸畏慕|国势寖安强
与物相忘久|于何寄此情|秖应逢胜会|不觉句还成
如何清夜曲|偏向旅人喧|黄鸟春风外|悠悠忆故园
帝业山河固|离宫宴幸频|岂知驱战马|只是太平人
三日断行路|束薪无处求|床头周易在|且复送悠悠
夜过神定桥|老僧桥上跪|致语桥有神|曾作民捍卫
偶睹丑人丑|归来泪暗弹|丑予无处著|为尔何成宽
林庐亦云乐|欲语辄复已|取琴抚徽弦|妙不在宫徵
静夜听鸣琴|秋风动幽谷|何为钟子期|千古无人续
身在九疑麓|门当二水流|谁知剡中胜|朝夕助嬉游
好是迁乔日|春风集羽仪|柳塘西面树|不是万年枝
弄日临溪坐|寻花绕寺行|时时闻鸟语|处处是泉声
客到暂开扃|春芜生满庭|主人殊不顾|修竹为谁青
丹篆钗符小|朱丝臂缕鲜|都无邪可辟|祇有寿方延
落落风骚怀|无端易衰老|天涯又暮春|白发对芳草
平湖泻明镜|上有修竹林|把酒对山月|谁同秋夜心
山溪信清浅|入海作洪波|果向地中转|应随天上河
扰扰横州路|征夫意自闲|数声秦吉了|一枕乌蛮山
梅花千树雪|松叶万溪云|湘源行日日|赖尔洒尘氛
家寄关西住|身为河北游|萧条岁除夜|旅泊在洺州
似我华阳洞|何时住七真|问僧僧不语|为拂石床尘
少年恣行游|老病徒拘缀|送君今夜心|还到苍梧去
皎皎天上月|照此池中水|运行无停机|容光亦鉴止
红白相嗣繁|色纯香亦浅|相对庭户间|俗尚焉能免
小筑西郊僻|浑如杜草堂|不烦严武驾|特过碧鸡坊
天清照逾近|夜久月将远|墙东双白杨|秋声隔窗满
日寂秋容暮|天寒野色悲|林中无偶坐|独制武陵词
去时数点雨|归时数片雪|雨雪两不多|山路双清绝
张王旧时宫|零落数枝柳|不是春风生|芳菲讵能久
头角昂藏出|经春卧夕曛|无人来问喘|嘘气自成云
三十年中事|鸾栖筑小亭|寒声长新箨|清閟拂疏棂
要路何曾著|闲门积渐多|五陵松柏外|随雨上盘陀
鸭壳非难致|鲛胎业已成|夜深宁觅睡|相照月偏明
悲哉生我句|奈此念亲何|墓侧有枯树|诗中无蓼莪
林里光初出|湖中气欲来|好随松影去|且放竹扉开
湖上新春柳|摇摇欲唤人|多情今夜雨|先洗马蹄尘
秋雨歇复下|西风微自凉|不妨舟系柳|已贷汗反浆
竿竿有参差|叶叶无量限|不根而自生|换却诸天眼
远分穰下美|移植使君园|何人为修贡|佳味上雕盘
白玉开洞房|药田元气湿|老龙雨四海|向晚随云入
鹊饮树底泉|人立石边路|相亲不相疑|所性平等故
雪助湖光白|风开野色新|白鸥相识否|前度弄梅人
移来蜀相祠|曾息轩皇驾|乍宵风雨声|恍惚苍龙下
苍官可长雄|馀子皆季叔|所以吾外家|深栽后彫木
白绩含闺怨|吴蚕五月空|但知桑叶绿|不识茜花红
风叶响秋林|烟梢带夕阴|美人离思远|湘水夜来深
自得湘江种|禽栖不敢弹|怕摇枝上露|犹是泪琅玕
我来寻幽奇|破屋枕木末|向阳窗不关|川僧补直裰
人传月中树|恐是山河影|片石补天馀|参差碧云冷
邺中三十秋|未识太行路|我来风雨多|无乃山灵妒
山中多白云|栖我亭前树|日暮度前村|又与东风遇
江流知几曲|尽是荔枝湾|一艇潮凫似|随潮日往还
端忧更贫病|不分又花时|只说春何好|犹堪入小诗
山前红树合|山顶白云封|山中有兰若|日暮闻疏钟
直干解新箨|低枝蔽旧丛|芟繁留嫩绿|引月更添风
行蚁醒槐梦|游蜂静蜜衙|嫣然成一笑|更爱雨中花
一州两迁客|无地顿奇材|方送端明去|还迎博士来
虎溪流曲泉|鹿门隐高树|山人不入城|日暮自来去
蓝田战秦将|子婴竖降帻|至今柏树精|疑是卧龙魄
海子西入城|中与龙池连|高楼沙口望|正见打鱼船
礼称亲未葬|丧服不除焉|食麦断盐味|悲哉四十年
昔移红白种|同种谢池中|一朵不留白|两池皆变红
独有青山思|不随芳草移|今日东风至|花开仍故枝
桃李已成尘|葵榴各斗新|红颜年少子|白发背时人
可怪直沽水|翻为丁字流|扁舟何处去|风起浪悠悠
溪定咽复流|山空翠犹碧|横琴抱未弹|幽意不可得
迎送山相似|舟移迷北南|回看皂口日|已照石华潭
河流未易清|海波亦难晏|不见淮徐间|深谷为高岸
凉风绕树秋|长河络天碧|深宫悄无人|月暗莎鸡泣
祀罢灯花喜|山游晓色新|江头送归客|我亦是行人
盘盘樵牧地|何年字马盘|数声牛背笛|不用跨雕鞍
东床卷席罢|濩落将行去|秋白遥遥空|日满门前路
船内然孤灯|船外飞细雨|默坐数浪声|回头见苍鼠
倦鹤寻流水|闲云归故山|青囊书在否|留取教人闲
石滑岩前雨|茶香树杪风|江山无限景|都在一亭中
塔倚高标立|楼深一窍虚|海风吹幻影|颠倒落方诸
尘浥多人路|泥归足燕家|可怜缭乱点|湿尽满宫花
去觉横塘近|来惊初路遥|因听竹枝曲|倒把木兰桡
夤缘映层阜|苍翠复春苔|君知爱霜雪|若个是龙材
滁州不种马|千里稻田枯|空坐两太仆|劳劳付笑歌
画屏绣步障|物物自成双|如何湖上望|只是见鸳鸯
映竹疑村好|穿芦觉渚幽|渐安无旷土|姜芋当农收
岸蓼花如糁|残霞照晚汀|不教资曲蘖|留得隐䴔䴖
不为世网萦|肯受儒冠误|兹游快平生|并了泉石痼
棕笠溅飞珠|回头不知处|徙倚望前山|斜阳转高树
春风吹石城|日日唤花开|可怜花上月|不唤莫愁来
吾读楚骚词|纫兰还结茝|何似坐兹亭|长与芳菲对
凉月清襟抱|闲吟气正和|熟思刚暴性|旦昼梏亡多
不可有所欲|有欲累不浅|君犹未深信|吴王与勾践
空谷结层云|寒泉落空沼|中有太古灵|悠然隔深窅
高楼生紫烟|遍绕琅玕树|一出西郭门|仿佛函关路
春信到琴边|声成意已传|须裁太古曲|天上和虞弦
山川殊壮丽|井邑亦繁雄|独有羊城庙|萧然瓦砾中
车唤阿香推|情知雨必雷|不干巽二事|也伴阿姨来
络纬复络纬|一虫还一虫|年年声不断|未了禦寒功
人生嚣尘中|几若驹过隙|安得坐此山|枕流复漱石
峰色秋天见|松声静夜闻|影孤长不出|行道在寒云
瀑流悬绝壁|峰月上寒空|鸟鸣苍涧底|僧住白云中
真作寒灰好|禁他冷灶头|烧灯围傀儡|鲍老汗珠流
空复出城来|问君还城去|寂寂掩双扉|忆君情不叙
水稻苗初绿|畦桑叶渐稠|羡人耕凿好|宽我乱离忧
骤来泉瀑乱|暂歇云流青|钟磬昼不响|空山自泠泠
俗氛炎郁攸|世燄毒恶来|清当友孤竹|隐当友仙梅
虽云居异方|政自生同宇|不但撷园蔬|仍须催酿黍
材大难为用|谁将此老悲|空山独高洁|不怕雪霜欺
丑夜方向寅|被衾冷如铁|江南贫者多|奈此霜加雪
六合横驰骛|道人门不开|回头顾明命|鞭辟入身来
朝亦见潮来|暮亦见潮来|维舟不敢渡|西望兴悠哉
不愁秋气至|弃置归箧中|当时万里翮|扶摇快秋风
海岛已无泉|三军几断烟|贞诚虔拜祷|汲引任回旋
尊年乡饮礼|击壤太平歌|甲子君休问|光阴得最多
淳湖一夜月|羁客带愁过|相遇他乡客|他乡思转多
角里旧餐馀|化石颇奇古|耻入丞相庄|移来司谏圃
春日湖容丽|天高雨气舂|逢时多感慨|独睡万山中
棹弭龙门下|诚驰天阙边|平生畎亩意|祝圣更惓惓
客子厌京尘|长街风眯目|安得卧南阳|清潭渍寒菊
品轧酴醾架|名疑雾淞花|□将□假借|可但鄙金沙
佳山路不远|俗侣到常稀|及此烟霞暮|相看复欲归
黄卷漫穷年|天梯欲上难|闾阎听小子|竞欲裂儒冠
亭树霜霰满|野塘凫鸟多|蕙兰不可折|楚老徒悲歌
君颜犹少年|我发不胜帻|百岁垒一丘|主翁惊是客
宿草发新荑|沙乾叶未齐|待教寒食雨|绿映锦障泥
凤苑开丹燕|龙楼下翠华|天工不敢住|春日著春花
怀哉送舅氏|曰至渭之阳|念母如存意|悠悠寄二章
紫皇坐瑶台|敕我草洞章|落笔三百首|饮我白玉浆
舟浮香溪来|是我餐霞友|小女采荼蘼|已泛长春酒
溪月知相忆|江云约共吟|夜船书一纸|飞过赤枫林
浣沙吴女郎|临江出素足|相逢不得语|回眸背人瞩
明月招我饮|白云披我衣|莫言生事少|镇日灌园归
霜朝庭耸玉|雨夕院敲金|一自淇园后|诗人几废吟
年年寒食节|院落梨花吐|何处鹁鸠鸣|纱窗夜来雨
种得筼筜玉|庭含五月秋|清诗吟卫武|绝胜伴羊求
暝色生前浦|日沉西岭树|隐约有孤僧|远入深云去
骤作中年身|都无快心事|不知筋与骨|何处将衰至
畜驴无贵贱|驴多不值钱|江南坐诗客|北地背薪还
昨夜裙带解|今朝蟢子飞|铅华不可弃|莫是藁砧归
新栽杨柳树|近水欲成丝|春风容易歇|莫遣笛频吹
雪瀑下平地|便作人间去|石潭如有情|少遣潺湲住
古井玄泉色|仙人玉镜寒|照来知骨相|作意就金丹
送穷穷不去|相泥欲何为|今日官家宅|淹留又几时
徐庾空浮艳|何曾有一篇|我朝惟二宋|绝唱两三联
三年天下共|胡尔独终身|无处着深痛|何心求过人
老骥千里志|元龙百尺楼|想同湖海心|逸气横清秋
宦情长淡泊|行橐转萧条|独有秋山色|相随远入朝
苍然蓝田姿|幽怀莹冰雪|邂逅青门翁|曾救人间暍
雾涨苍龙鬣|风鸣紫玉珂|骏群空冀北|天象动荥河
闻道菖蒲节|龙舟一一修|雨凉虽少憩|郡圃不妨游
薄暝易相识|月明何处愁|分明枯树里|望绝白云头
吹笙伊洛来|凤鸾犹可遇|傥得浮丘公|接上崧高去
九扈鸣已晚|楚乡农事春|悠悠故池水|空待灌园人
霜蟹丰两螯|磊落登盘盂|亹亹倦咀嚼|繄我愁独无
玉骨换丹砂|夜雪迷春色|欲学彩云飞|东风苦无力
散步入空林|斜阳满山麓|四顾寂无人|蝉声出修竹
开社白莲秋|出山余暂游|君忆柴桑客|江边一倚楼
庭院静如许|时闻落叶声|日边云气滃|树影不分明
老贼顺流下|周郎凭轼观|不干春水事|一蹙走曹瞒
山隐一抔土|人思百代传|无穷身后事|未若子孙贤
自有幽闲姿|本无出山志|谁使清风来|吹香落人世
高城今旷野|比屋昔朱门|道上传呼过|遥遥几世孙
授经何循循|标行乃岳岳|虽践五鹿称|畴忍折其角
康邸龙飞日|中原不可支|乘舆犹北狩|泪湿画中诗
两三啁哳雀|飞飞自容与|天地无网罗|郊原熟禾黍
心地邪花放|五叶逐根随|共造无明业|见被业风吹
手折琼瑶枝|欲以赠远者|姑射冰雪姿|乘云不来下
边地莺花少|年来未觉新|美人天上落|龙塞始应春
剑江有前辈|高谊重儒绅|明日耆英里|添君是几人
烨烨承明庐|上考书第一|白首洛阳才|呻吟卧蓬荜
花落烟江口|青苎新槽酒|索寞辞官资|还家奉眉寿
溪光倒彴影|彴影跨溪垠|非论权取意|聊订济涉仁
三五近春宵|长空万里遥|预期华月满|先借彩灯烧
写竹如草书|历乱不成行|只疑风雾里|烂醉过潇湘
人生日营营|得失为心患|世事尽浮云|冷眼林间看
艾纳护春香|横枝偃霜月|绝怜玉妃面|化作铁汉骨
廨里双林月|城边一涧烟|西斋诵经罢|寥寥兹夕眠
平湖五百里|江水想通波|不奈扁舟去|其如决计何
离馆背寒塘|霜清野菊芳|美人千里去|明日是重阳
一笑出隆中|黄星掩日红|妖氛不敢作|白羽起西风
寂寂维摩室|萧萧般若台|山僧谈学士|曾此借眠来
柘弹黄金子|谁将满树装|珍禽来往惯|风落不惊忙
两眼明如月|江湖度十春|问谁当鼎贵|笑说未逢人
玉宇晴光发|金桥曙色明|倾葵今在念|炙背旧多情
沽酒渭桥边|平陵侠少年|相逢各有赠|宝剑与金鞍
虚斋篆炉烟|兀然得禅寂|虽有锦绣肠|画饼安可食
南枝春信早|倦客鬓痕深|岁晚空江曲|相看只素心
孟氏求放心|羲易戒迷复|可叹声利场|纷纷竞驰逐
功名就烜赫|遗训可能忘|待献明光赋|蜚声满四方
采莲折却藕|藕折丝不绝|回船向中流|绾作同心结
江寒浦溆多|举目皆衰草|惟有拒霜花|遥遥隔江好
晴空无一碍|云鸟结霄邻|自顾劳劳者|独驱马足尘
倒打钱塘郭|长驱白浪花|吞吴休得也|输却五千家
万树寒无色|南枝独有花|香闻流水处|影落野人家
懒成真似病|山妓笑酣歌|花落煎茶水|疏丛蝶未过
闻我来何数|非关引兴豪|风尘燕市里|或恐有荆高
芍药新移种|红拳餐万雏|看来已可爱|未问有花无
南北两石门|上下一灵鹫|仰看莲峰立|忽见天门透
露沐千门柳|风萦九畹兰|会听莺出谷|行傍采桑坛
洞天人远矣|琳馆有遗踪|愿弃人间事|优游慕赤松
沙路行人绝|疏灯映竹扉|江村烟火夕|知是夜渔归
冢上两竿竹|风吹常袅袅|下有百年人|长眠不知晓
瑞日明天仗|仙云拥寿山|倚栏春昼永|金母在人间
地僻无人到|松风鹤梦清|一灯禅榻畔|自向暗中明
皇心本夷旷|一气自炎凉|不废荆吴旧|民风见未央
何处忘人世|平生此石床|秋来难出户|恐负菊花香
谁言玉井春|不作双井味|会有眠云客|领略两相似
朝泛赤栏湖|暮宿黄金浦|多少采菱船|来问襄阳估
环睛难为病|侵睛多即惊|月中骑亦惧|云内更同盲
酷暑睡不稳|解衫周四围|但阻蚊虫入|无遮明月辉
月翻惊鹊影|风咽乱蝉声|独坐忘尘虑|宵分梦未成
冻雨涨中庭|微风沦止水|泛泛藕花飘|眇眇仙茅靡
谁得陶朱术|修池一水宽|皇恩浃鱼鳖|不复敢垂竿
作伪欲成真|狞狰门上挂|若教鬼有灵|看来应未怕
霜螯百镒重|人世一身多|我意已凄惨|如君风味何
赤藤可扶险|青藜堪照书|老师竟何为|暮齿随安车
倚杖长松底|无风昼自凉|吾庐傍林壑|嘉木耸千章
别欢夏夜长|逢欢寒夜促|玉腕杵兰膏|调作罗帷烛
霁景明如练|繁英杏正芳|姮娥应有语|悔共雪争光
嵯峨千仞壁|上有万古苔|萋萋风雨色|终不带尘埃
卢破黎头出|李子始花开|潭深鱼正聚|杨柳两边栽
穷阴閟岩谷|积雪满山川|只有江梅树|相看似去年
化国有馀暇|丰年多醉人|典衣谋一饮|对酒却惭春
硙湍方电激|曲屑已云霏|诚哉智者乐|力少功不赀
翰墨功名里|江山富贵人|倏看双鸟下|已负百年身
天末望归云|迟徊憩檐宇|杨叶自多风|愁来更秋雨
借来壶作枕|笑傲足烟霞|莫著籓篱想|空中纳九华
长安十丈雪|寒色满荆榛|唯吾咫尺地|留得故园春
碧沼澹怡神|遗编暂一伸|病躯何所事|时作饲鱼人
空谷有幽兰|久矣无人识|君子来不来|日斜思如织
古研麝煤香|书传雨漏墙|高斋对松雪|随意写潇湘
梦笔异文通|诗篇总自工|长哦三伏里|句句是清风
微月人生影|轻风船弄波|明朝还夜直|凉爱北湖多
凝霜压寒芦|白月铺净练|谁起落梅声|愁人泪如霰
作白岁已晚|能红春未深|天地固□□|□□□□□
做了高官职|双眉皱不开|譬如三日妇|锦袜著珠鞋
丽日凝丹阙|光风拂紫闱|欲知春色早|先上赭黄衣
劲节生宫苑|虚心奉豫游|自然名价重|不羡渭川侯
打鸭惊鸳起|忘鸥得𫛶驯|世间能去我|物外总输人
弥勒禅林雨|将军陇树烟|长安今罢笑|留恨向西天
金阊十万家|尽醉吴山碧|独有王子猷|回桡墓田色
今日竹林宴|我家贤侍郎|三杯容小阮|醉后发清狂
风尘淹白日|乾坤霾涨海|为我问故人|离别今谁在
北风吹大雪|向夕满空山|遥见山中客|悬灯草屋间
雾外知何寺|钟声只隔山|望来无里许|还在九霄间
兰津环一带|万古自春秋|时发沧浪咏|矶头濯足流
数日不饮酒|形神故自亲|三年不读书|舌本快于人
山溜碧泓澄|清甘归色味|傥逢张又新|应不落第二
明洁众所忌|难与群芳时|怀贞岁华晚|只有天地知
天上春光别|时康乐事繁|烟花浮阆苑|露叶簇金盘
江海扁舟客|云山一衲僧|相逢两无语|若个是南能
秋水凝细縠|秋月明双杵|江南雁欲归|来向帘前语
中兴虽帝业|内治本阴功|天下供荣养|方知福报崇
团扇画方新|金花照席茵|那缘灯下见|更值月中人
小小比肩时|春来忍别离|不须烧鹊脑|已使妾相思
怪石如排衙|罗列亭两畔|森森整旌纛|岌岌峨冠弁
四彻澹空明|清辉映寒玉|欲将五十弦|中夜弹一曲
圯上求西舍|隆中买北邻|种花行造化|移竹试经纶
六出吐奇葩|风清香自远|树如天竺林|人在瑶华馆
檐溜停清泻|林声息怒号|水浮秋色远|山带夕阳高
城郭有时变|市朝回首非|谁为辽鹤说|第一莫来归
负笈何方来|今朝此同席|日用无馀功|相看俱努力
水如剡溪水|山似沃洲山|想见鲈鱼美|扁舟常不还
夜来微雨过|涧谷生春水|土脉肥荠苗|烟痕带梅蕊
吕梁洪下水|已变作安流|安流虽自好|只是滞归舟
妾乃石楠花|名为端正树|为君守岁寒|不忍辞霜露
大泽荒草阔|行人心惨凄|边云时断续|流水自东西
去避坑焚祸|来成羽翼功|留侯不自语|驱使紫芝翁
谓是苏长公|如何抱丝桐|不必穷是非|闻名自生风
馆外暮云白|羽客时迎送|婆娑屋边树|传是梅仙种
青士长得瘦|翠兄工买贫|向来素爱者|已赚一诗人
青山万古色|流水一江云|远寺钟声早|迢迢月下闻
平生老骥心|伏枥端有在|华月生夜凉|南窗歌慷慨
偶植还篱落|春风也弄芳|三千宫黛晓|休妒露华香
朝昏看开落|一笑小窗中|别种蟠桃子|千年一度红
十年虎溪老|却上羌山岑|今回江西去|与人传法音
不寐回寒鬓|乡魂畏路多|满衾掀不去|无奈月明何
飞来小坡坨|未雨已滂濞|荒此定何人|苏公有遗记
汉宫娇半额|雅淡称花仙|天与温柔态|妆成取次妍
帘外百花香|金杯照春色|对客骂奚奴|不添鹦鹉食
行草得三昧|林间尝与语|秋风忽捲衣|别我之何所
湘江玉一枝|风节清如许|扫榻致秋阴|鹧鸪啼莫雨
颗颗龙睛赤|深深映石门|自怜非荔子|不得荐尧阍
乍脱惊涛恐|犹为曲木看|昔人憎胜母|吾亦畏长滩
京兆归何处|章台空暮尘|可怜鸾镜下|哭杀画眉人
若说真州水|时人不道甘|天宁老谁识|板齿毛𩭹𩭹
本从腐草生|聚为寒士灯|一朝书课效|功宁不汝矜
寒林几吹折|冻柳不胜垂|老去机心熟|惊鸥莫浪疑
柈献千年实|杯行九节蒲|至尊亲上寿|家庆列成图
宝轸流薰唱|仙壶永瑞曦|欲知人厉息|天报艾生迟
吾本来唐国|传教救迷情|一花开五叶|结果自然成
民乐袁公惠|为亭古涧边|名标公姓氏|要与万人传
西南失大将|带甲满天地|高人忧祸胎|感叹亦歔欷
竹绕茅亭外|泉流石涧中|一天秋月夜|千载隐君风
汉口来何易|湘江去不难|北风吹顺水|三日到齐安
真水黄芽长|香风玉杵鸣|不为三窟计|永伴一轮明
露下银塘净|娟娟照雪衣|銮坡无限好|莫恋钓鱼矶
万里来珍贡|风澜静四溟|鱼龙惊咒水|神雾忽生庭
浮云本无根|触石成遛逗|题诗扫石镌|无用拂红袖
乱草藏边路|寒禽下戍楼|伏波渠水浅|难载济川舟
柳色青堪把|樱花雪未乾|宫中裁白苧|犹怯剪刀寒
春令园中本|移来村墅中|大官今却献|黄帕不来封
云碓激泉春|仙犬隔花吠|采药独行深|天地非人世
东来万里客|乱定几年归|肠断江城雁|高高正北飞
剩欲逢花折|判须冒雨频|晴明开渐少|莫怕湿新巾
鸾死铅妆歇|人亡锦字空|悲端若能减|渭水亦应穷
露长纤纤叶|春添细细根|生涯惟水石|幽意自乾坤
炎歊不可居|起濯风露里|解佩欲遗谁|盈盈涉秋水
秋菊有黄花|万古长如此|谁知栗里风|却胜南阳水
雨将残暑去|风送新凉至|安得归梦成|长夜愁不寐
猛风拔大树|其树根已露|上有寄生草|青青犹未寤
都城一日雪|庭户浩已盈|呼儿试轻扫|留伴小窗明
万物正摇落|梅花独可人|空中三五点|天地便精神
晴日烘绵花|暄风吹豆荚|九月似春天|河边见飞蝶
不共山鸡啄|雌雄自作陪|寒山相对在|春水几时来
西园芳意湿|不闻春雨声|野人闭门睡|园中青菜生
月缺偏多感|月圆翻自悲|君看几圆缺|不异在家时
老境日向逼|学业靡所成|空想古英哲|怅然念平生
晓霭滋花色|晴辉发水光|何人露新缬|不管著秋霜
十里湖如镜|红莲个个香|大姑先戏水|荡散两鸳鸯
赠我无心著|还师理亦然|秋风归旧谷|明月上青天
山中雪纷飞|山下斜横枝|年年花雪在|只欠老逋诗
日落游人散|山寒起树声|玲珑石上穴|处处有云生
卧病经旬久|开窗思有馀|不知秋几许|黄叶满庭除
旧友无由见|孤坟草欲长|月斜邻笛尽|车马出山阳
一切法无差|水牛生象牙|莫将无量义|欲觅妙莲华
凫鹥踏波舞|树色接横塘|远近蘼芜绿|吴宫总夕阳
俯仰人间世|经年客未还|不堪持手版|马上望嵩山
坐觉日月长|还疑宇宙隘|长啸出山来|如在太虚外
饥禽值游蜂|欲喙屡张口|那知挟弹儿|林间候之久
人行冥昧中|遇坎辄自省|闻是微妙音|安得忘所警
鸟语烟光里|人行草色中|池边忽分散|花下复相逢
幽花发清香|芳林涨新绿|闲听山中禽|更倚篱边竹
万古消沈尽|浮云事几场|酣歌颓醉玉|休得问兴亡
雾雨昏不醒|东风晓能酸|我食日不足|宁忧三日寒
笠下眼似海|驴背肩如山|雪月品题遍|翻笑天工悭
昔日愁头白|谁知未白衰|眼看应落尽|无可变成丝
粉蝶非仙骨|随风过苑墙|穿花不敢采|应怯内家香
玉箸插银河|红裙蘸碧波|更行三五步|浸着老僧窠
愿似蝴蝶花|花开红烨烨|花落随风飞|复作双蝴蝶
戴琴妙一世|二子得其声|不忍遗音奏|各将新弄行
西庄枕江侧|颇足供钓弋|莺扬上苑声|柳露章台色
笔与子皆逝|诗今谁为新|空遗运斤质|却吊断弦人
辂死向千年|占书世失传|安知无肘后|留在远孙边
一点伤春恨|东风罨画楼|不知缘底事|敲碎玉搔头
今夜河西宿|无眠但数更|并船何处客|吹笛到天明
雁下秋已晚|江天风雨微|宁为聚沙立|不作傍云飞
三年作楚客|五月度吴溪|日射桃花岭|松阴𫛸鴂啼
孤亭临海涯|爽籁清炎暑|夜午浴红轮|隐隐千林曙
时流求法界|问取本真诠|了悟空皆寂|心明海月圆
道是深林种|还怜出谷香|不因风力紧|何以度潇湘
清凉依上界|阴雪四时凝|披襟当六月|真坐玉壶冰
虞卿为著书|卒岁坐穷愁|那知交字外|翻有逍遥游
所思终不见|渺渺政愁余|试向江头钓|怕逢双鲤鱼
西山正可悦|薄暮作鸦青|吟苦人初瘦|斜阳上竹屏
卑湿长沙地|空抛出世才|已齐生死理|服鸟莫为灾
迸穴穿篱出|狸奴知几头|真能参玉版|足可当珍羞
故宁戚以俭|罔或易而奢|致得千载下|人称问礼家
闲骑小步马|独绕万年枝|尽日看花足|君王自不知
连山桃李开|晴光烂如许|宁知明日花|不有今宵雨
恶言出于口|必至反其身|小子闻人过|当如闻父名
孤馆严冬夜|梅窗月可怜|清光横瘦影|吟对兴悠然
公如柳柳州|柳桥如柳浪|恼杀涉溱人|望望不可上
彭泽休容后|西风满面尘|故交零落尽|谁是素心人
枯干立亭亭|由来爱鹡鸰|何当草间奋|相逐上清冥
□籥须臾间|元功夺造化|比于战昆阳|此更论无价
昨夜孤村宿|春深人寂寥|庭前一株李|为我缟中宵
诗书启山林|德义久储积|嗣世知有人|新畬更开辟
天地何大郁|此园赖幽清|脱巾卧松下|起听风蝉鸣
有欲情俱幻|无为道始尊|云眠散幽帙|青山月照门
朝正开左个|玉帛古元侯|千骑东方至|朱衣在上头
孤芳不作干|奕叶自含滋|白石苍苔路|落花流水时
解剑辞边将|萧条白发新|无家也归去|胜作异乡尘
祖考精神散|子孙能聚之|淫祠祭非鬼|萃涣义何居
闯地篁生笋|穿沙草有芽|牛羊原上睡|春到野人家
八列方隅位|四周分至时|画疆兴庶务|地矩囿天规
浴起月到楹|柔枝方可折|薰风如有情|吹帘散香雪
暂游仁智所|萧然松桂情|寄言栖遁客|勿复访蓬瀛
新着杏红衫|试骑赭白马|马骄堤路窄|急为扶侬下
桃红含宿雨|柳绿更朝风|青鞋了穷达|时过芳草中
事过清眠足|心宽缓步宜|古人无限事|烟蹙几修眉
高人厌尘纷|不肯栖平地|木末敞轩窗|托此超然意
紫禁香如雾|青天月似霜|云韶何处奏|祗是在朝阳
秋蛩如有情|沉吟入罗幕|欹枕数残更|寒灯落不落
松罗石室中|清雅胜支公|地静无尘到|天高有穴通
先皇亲赐锦|著向战场秋|销尽蟠花色|将军更未侯
山势彰坤厚|天光薄太清|臣家书万卷|换得此楼成
银甲玉纤轻|花间乍啭莺|琤琤倾四座|尽是断肠声
隔涧白猿子|呼来验是真|一从沧海别|啼啸不知春
万峰环一岛|孤月照芳洲|兴为江湖远|珊瑚拂钓钩
篷畔养飞奴|如檐望却无|船人莫惊起|留得伴樯乌
莫谓蟾蜍小|渊源在许中|曹溪一滴水|驾浪作南宗
冥冥沙上鸥|洁洁云间鹤|秋风厉羽飞|空山惊寂寞
玉帛交邻后|清阴满塞榆|苞桑存至戒|犹佩辟兵符
漾漾带山光|澄澄倒林影|那知石上喧|却忆山中静
庭梢桂林树|檐度苍梧云|棹唱喧难辨|樵歌近易闻
凭将锦襜褕|绝意游南浦|感君明珠赠|不忍遇交甫
梅蕊如红稻|中藏无尽香|何时来鼻境|更待几番霜
徵君待访录|只在卷帘时|南宫与北苑|彷佛梦见之
观书了无味|卖文不值钱|烧笔偿文债|枕书惟高眠
斜日照江亭|风高水满汀|潮来鱼正上|谁肯解渔罾
独抱孤儿在|空帷泣夜深|谁家姑与妇|相继柏舟吟
胜觉乘机早|输怜得子迟|山中闲日月|只许烂柯知
已见池尽墨|谁言突不黔|漆身恩未报|貂裘弊岂嫌
犬吠人家近|鸟啼春昼晴|涧草有幽色|野花无定名
野鹤闻琴态|孤鸾对镜妍|为君小垂手|无地可回旋
外看江水长|里见荷花发|庐阜收白云|南浦浸明月
时时可问花|处处堪沽酒|风波君不知|愁杀楼中妇
楼阁摇清波|亭台隐孤屿|时听笙箫声|云端下仙侣
十年营一睡|醒起欲安民|忽睹金乌彩|还山遂老臣
生意草亦佳|可但莲菊好|富贵本何心|莫以色见我
父疾亦云笃|如何豁尔平|孝经惟泣诵|昼夜不停声
娇小青衣使|茏葱蜡瓣花|依然香韵在|清赏属谁家
摵摵初鸣竹|涓涓稍滴檐|忽然幽梦断|更觉晓寒添
故人满秦陇|为寄一言拜|问我今若何|病多慵束带
杭城打六更|市楼已攒点|流年莫催人|老色将冉冉
踏碎贺兰石|扫清西海尘|布衣能效死|可惜作穷鳞
岁岁中台使|巡行道十三|要知君历处|风土接交南
出门还致语|谁不念恩私|嫁女非无泪|其如已及时
梦魂荡孤舟|波声塞两耳|不眠闻管弦|方悟江城里
定居人种竹|居定竹依人|新笋甜于肉|长竿健似身
昨日登高罢|今朝更举觞|菊花何太苦|遭此两重阳
白发出门来|三见梅花谢|客路有岁年|归心无昼夜
白日湘江晚|黄云渭水秋|怀人不可见|烟雨满秦楼
应龙昔此去|雷雨助腾伸|旧穴潜鲛蜃|风波横要津
落落不对俗|娟娟净无尘|缅怀湘渭中|岁寒时相亲
广厦千万闲|吾庐弊独寒|犹将折弦琴|欲和薰风弹
蒸入琴书润|粘来几榻寒|小斋非岭上|弘景坐相看
懒摇白羽扇|裸袒青林中|脱巾挂石壁|露顶洒松风
行到黄云陇|唯闻羌戍鼙|不如山下水|犹得任东西
客路逢人少|春城不尽头|无风花自落|何处避春愁
蜗角身名异|蛾眉身态无|自怜田野质|谁复问泥涂
青山四壁围|一石凭空踞|问我来处来|真与去处去
日落荒山远|仓皇避虎狼|更闻狐假虎|流涕贾生狂
乍可餐菱荇|那能豢稻粱|数群烟雨外|恍忽似潇湘
梦作吴淞去|脍鲈捣香橙|道逢湖海人|欢宴如平生
才看花满枝|又见花零落|春光不自留|莫怪东风恶
花落飘碎琼|果熟染黄蜡|张君鼻观间|莫著兰麝杂
寸寸水痕长|中流砥柱鸣|本来无酒量|强酒压江声
朝看楼上云|日暮城南雨|路远香车迟|迢迢向何所
娟娟生玉润|楚楚作金声|羽扇迎风定|羊车过月明
昼漏新添刻|春寒早放班|恩随宽大诏|一日遍人间
何年顾虎头|有此传家手|老夫细摩挲|俨似黄子久
困来宁退休|倦容勿对客|勿易吐肝胆|而令辞气迫
假守昭平郡|偷闲少送迎|亭标梅句老|堂识敬公名
朝朝一味豆|日日寸心葵|每抱丰年愿|乾坤未有涯
冀缺与梁鸿|何人可比踪|丈夫志四海|恨汝不能从
压蔗出寒浆|敲冰簇画堂|人间正袢暑|天上绝清凉
道人西涧来|衣上南山雨|心知石堂烟|晴峰正堪数
东日照瓦霜|西向界馀白|莫言日不到|日光来未及
薄命红颜是|倾城亦枉然|君王七宝殿|自拥少儿眠
擢翠向人孤|潭潭省署虚|雨馀秋更晚|风月共萧疏
醉红睡未熟|泪玉春带雨|阿环不可招|空寄凭肩语
放逐臣之常|胡为乎汨江|不先于楚死|未免作秦降
怪道枯梅树|天机不解藏|如何寒雪里|独著有幽香
天井无人汲|汲之愁太勤|忘助中间看|天人此处分
生意满孤根|香凝粉节痕|惊看雷雨夕|化作老龙孙
汉人称劲粤|累世不加兵|狂卒才三百|如何便缒城
清晓异香焚|山堂吐白云|窗风环佩响|疑下云中君
古事参今事|今人乃古人|只应情未浃|情浃自相亲
午日照柴扃|先生宿酒醒|科头了无事|散步读黄庭
云冻月笼影|风生水涩寒|故人真似雪|何必到门阑
振振风生柳|沾沾雪点矶|白攒秋水立|青映暮天飞
古道逢元夕|荒山惨暮烟|桃花虽作意|未是艳阳天
当人如举唱|三句岂能该|有问如何事|南岳与天台
寂寞书斋里|萧萧送雁群|弹琴复长啸|情发为知音
画阁方裁扇|寒塘又凿冰|蓬壶山四彻|何处是炎蒸
锦织双鸳鸯|还自裁为衣|恐入他人手|不解惜分飞
心缘身外境|法相本常存|若求无生理|先明取善根
不见朝元阁|难寻羯鼓楼|繁华随世去|唯有渭川流
雪没驴腰白|行行诗兴催|不因太清绝|那肯犯寒来
黄叶下西阪|山空秋正清|永夜无人语|残河尽意明
分得剑溪春|种向仙人家|但供玉川渴|不学君谟奢
灵药满芳洲|丛生不用植|最好武陵人|采采供服食
不能战涿鹿|聊复隐崆峒|挥手谢轩帝|毋烦顺下风
跣行无履袜|科首匪冠巾|绝域亲朋远|何由见故人
煖日黄金柳|光风白玉梅|门阑开寿域|人物满春台
偶语犹弃市|一椎何自全|秦皇十日索|不向圯桥边
土气昏风日|人嚣极雁鹅|寻河著绳墨|诗思略无多
象应轩龙次|恩承帝座光|燕坛风澹荡|蚕馆日舒长
小艇渡行旅|往来终日操|但令人利涉|宁复计劬劳
翳翳白日静|迟迟青山行|心兜试宽窄|恐母坐不宁
蛾眉迷叶翠|龙脑乱花香|两岸肠堪断|伊人水一方
秋风饭颗巅|吟成一登眺|日暮谪仙来|相逢应大笑
一笏清凉地|森森万玉齐|月明时倚杖|闲看凤来栖
星散南山寺|乘春取次登|封筒来往数|随处得诗僧
东艇拍西艇|小拍庸何伤|夕风起惊涛|艇艇争低昂
去年今日时|桃李半狼藉|能随里门儿|买饧作寒食
书报天中客|看花思不胜|韶光一如此|年鬓复相凌
藩兄欲学书|来问学何如|孝悌为根本|文章特绪馀
忆昔矜容色|如今懒抹涂|谁能面皮皱|施粉又施朱
土阶堕渺茫|多少曹与马|底事住青山|近代无让者
晨起拜大家|向夜拜新月|堂前人不闻|风吹徒切切
垂緌饮清露|流响出疏桐|居高声自远|非是藉秋风
寒飙昼相忆|悲歌夜相见|斗室岂天台|落尽桃花片
山中未云寂|半夜有松涛|不寐初来客|开门月正高
不负百年心|琴中托意深|如何浑忘却|犹费白头吟
春到村居好|清明欲禁烟|乱红桃下雨|轻白柳飞绵
临池构杏梁|待客归烟塘|水上褰帘好|莲开杜若香
秋叶与秋云|的的当阶坠|家僮误扫叶|惊散秋云去
香径藓花生|阴檐藤叶绿|日长不耐闲|行溪看鸥浴
中条春雪积|太华晓云盘|气接河冰白|光摇野日寒
月照庭上雪|灿若玉玲珑|风吹雪如絮|飞入锦屏中
马上客衣单|途中书信难|别离秋易早|阶前露不乾
西园草碧色|南湖水绿波|五云亭上意|争奈艳阳何
结屋山中住|寻幽曳杖行|独来松树下|坐看白云生
去国三千里|风波岂不赊|回思洞庭险|无限胜长沙
器乏雕梁器|材非构厦材|但将千岁叶|常奉万年杯
玉宇含清露|香笼散轻烟|应当结沈抱|难从兹夕眠
罗衣束素云|绣履裹纤玉|低回不自前|含娇灭华烛
精力苦日短|乘闲强登眺|登山陟其顶|倚云发孤啸
卜筑青山下|白云任往还|多情花下鸟|相对语关关
苦竹湘妃笋|黄金嫩若钗|今朝刚浴佛|小妇亦清斋
荷笠扁舟上|持纶巨泽中|无劳问名字|便是此亭公
爱酒惜杯乾|懒衣愁客至|世无锦江翁|谁识幽人意
幽人倚孤松|垂钓沧浪波|游鱼未吞饵|水风吹绿蓑
仲冬垄梅发|繁英簇红霰|过意百花魁|翻疑百花殿
晨登苍崖巅|夕息苍崖足|手把青松枝|坐看春禽浴
日日人空老|年年春更归|相欢在尊酒|不用惜花飞
待制传宗嫡|元孙见可人|承家在好德|切莫厌清贫
尤物钟芳草|虞兮柰若何|动摇缘体弱|非是感悲歌
长江春水满|瀰瀰绿如苔|行人过江急|江阔船不来
天子飞黄马|牵来赐近臣|玉阶新雨过|风滚落花尘
自惭闲索居|岂贪颜色盛|爱渠真不言|可以通三径
春风来几日|先入辟疆园|身外无馀事|闲吟昼闭门
风引孤舟行|登楼听呜咽|春江万里流|半是巴山雪
亭亭玉芙蓉|迥立映澄碧|只愁山月明|照作寒露滴
云阴带残日|怅别此何时|欲望黄山道|无由见所思
已作湖阴客|如何更远游|章江昨夜月|送我到扬州
一水遮金骑|诸州办甲衣|书生投笔砚|随口说兵机
临分亦泫然|不为穷途泣|东阡时一到|莫遣牛羊入
戟棨严门第|镮金倦带围|如公三事老|从古几人归
翠叶迎晚烟|黄花过秋雨|我思柴桑人|西风但延伫
今朝好风日|策马东郊行|双柑挈斗酒|往听黄鹂声
鹞子贴天飞|鸿雁嗷中泽|挟赀作郎官|幽州马行客
王孙馀巧力|银汉亦经营|地轴卷不尽|风梭织又成
闻道乘槎客|相携到汉庭|何缘尝草日|先自入医经
远寄陈传道|穷秋亦罢官|还驱款段马|吟雪向长安
直上飞云上|凭高识大观|山环全粤小|地尽海门宽
人生都几日|一半是离忧|但有尊中物|从他万事休
野阔烟迷树|江清水学天|白鸥盖具眼|终日老人边
披拂桃花风|独往孤云意|山中久忘言|寄客无文字
芳丛杂芝蕙|称此北堂幽|为园自可乐|那必尔忘忧
翼翼瞻斋殿|深严步苑廊|三人俱汉杰|一老玷周行
采樵沿岭去|提水傍溪归|个般无出豁|七佛不曾师
三贤堂趣远|四照阁诗传|高节无人继|孤山只俨然
裁作牛腰束|愁于饭颗山|近觉故步窘|十债九不还
千古灵胥怒|惟知有伍奢|安知崇伯子|北面事重华
何日春风来|幽兰绿如剪|细雨山气凉|秋香入苔藓
好日信无多|良会诚难值|切莫俟其时|始叹空相识
细韵风中远|寒青雪后浓|繁阴堪避雨|效用待东封
溪深龟鱼骄|石瘦椿楠劲|借子木兰船|宽我芒鞋病
朱实凌霜熟|金衣向日荣|无论千树贵|聊玩岁寒情
纵横十九路|一著一回新|如此深山许|旁观亦有人
肺毒若生疮|医之要肺凉|贴药虽宜洗|可用甘草汤
眷此栽花地|而多种秫田|桔槔偏不用|鼓腹乐尧天
去家十里遥|结茅在深树|白云洞口来|忽与幽人遇
寒雪梅中尽|纱窗薄似烟|怨魂迷恐断|多是晚风前
不读昔人书|那知当代旨|自信阿龙超|任将周𫖮比
蓟北雨连晓|江南定若何|还应碧窗里|灯影暗银荷
箫鼓震阳休|组练照芳洲|意气坐中客|羞笑山阴游
嗟来何足吝|饥食首阳薇|竟抱固穷节|千载非所知
营营止于棘|或赤而或黑|皓皓染成污|奸魂并佞魄
关深羁思满|风断绿阴单|一遇空门侣|那知行路难
荡寇将军后|唐朝李郤家|绿华双荐者|况复古今夸
青灯人语寂|池塘响蛙蛤|孤坐如老禅|门开风自阖
晚花含蝶影|秋水点萤光|一夜思归梦|随风到草堂
芙蓉近可攀|香草供幽赋|公才如命骚|此是冥搜处
滁流亦沂水|童冠得几人|莫负咏归兴|溪山正暮春
幽禅吾不学|静处岂无心|日转眠双树|风和散两襟
为爱松隐名|去觅松隐迹|只在此松间|觌面不相识
武帝有荒志|终童无远谋|长缨自系耳|莫系越王头
地惭扬子宅|草似郑公乡|书卷年来废|空翻白日长
野旷悲行客|湍惊碍去船|夜江清泛月|秋草碧连天
江云如镜平|月当秋夜白|欸乃一声歌|舟中南北客
迸月川鱼跃|开云岭鸟翻|径斜荒草恶|台废冶花繁
小艇如凫鹥|湘东柴杉木|载家复捕鱼|夜夜系江竹
丛翠当轩密|新阴南席移|晚来风雨至|应长出墙枝
世乱云浮薄|年荒虎迹多|邻翁近相戒|日暮少经过
二月寒蝉至|哀鸣乱叶中|林花满眼发|萧飒似秋风
凉夕逢秋半|仙杯坐漏长|未须延桂魄|卿月在薇堂
解擘当胸箭|因何只半人|为从途路晓|所以不全身
江上望归棹|君归未有期|试看圆缺月|是侬断肠时
箕踞长松下|忘情白发新|城市有名利|江山惟白云
风暖轻拖练|天寒皱作靴|江湖只如此|今古几消磨
路转歌声杳|夜深云露浓|美人行月下|秋水泛芙蓉
沧江无尽水|夜夜随潮去|若复作潮来|沧江止不住
松下无喝道|言树聊蠲忧|谁知赤藤杖|独倚万古愁
田野尽成赭|无处诉凶荒|额输且莫登|况复加徵粮
深洞回尘鞅|闲云锁石扉|采芝从此入|愁湿薜萝衣
树绕滕王阁|溪流徐孺祠|昔年游赏处|花落雨丝丝
梦断江南信|空怜铁石肠|绿么何处去|二鸟独悲伤
风露枯肠里|宫商两翼头|壮号森木晚|清啸茂林秋
临行重嘱咐|人世贵自持|愿汝得饱日|毋忘饥饿时
向南马齿口|野放咬山多|区臼虽先破|莫言齿岁过
虽老未龙钟|篱边菊满丛|乍凉天气好|里闬正过从
草满南园绿|青青复间红|花开不择地|锦绣径相通
万古写不停|玄天无一墨|我欲往从之|苍苍本无色
舟小从波兀|桥深爱树遮|风烟生远思|何必慕乘槎
时或率天性|分明大道行|无端翻自悔|苦媚世间情
云开见山雪|院静闻松风|吏去曲肱卧|疑非尘世中
金马春寂寂|秾桃随意开|夕风零落尽|不待主人来
江畔送行人|千山生暮氛|谢安团扇上|为画敬亭云
倚窗春睡觉|折玉满手香|𥮾云疑未稳|指点问檀郎
八月流潦清|空江净无暑|徘徊见二妃|疑到黄姑渚
春残兼暮景|志协怨离居|处处堪乘兴|时时有报书
停棹更须臾|尽此一杯酒|莫忘相别时|鹅黄上杨柳
君父今安在|谆谆免矣乎|可怜齐女子|不问辟司徒
历也驹千里|新诗慰远思|霜秋鱼酒美|来趁寿觞时
采花莫采叶|采叶恐伤藕|藕中多乱丝|缠绵那得久
邑事多商榷|惟诗未暇论|母慈催扇枕|父老欲攀辕
天远青山小|林幽碧树深|清风与明月|相对即知音
及肩新种竹|濯足旧疏湾|钓月鱼为伴|偕书僧送还
风音来夜叶|雪片挂朝丝|影响归何处|凄清独在兹
雷霆岂不闻|蛟龙时亦过|不愁眠不熟|此不是风波
智悟悟自心|不在一切处|回首时观瞻|便是佛国土
施水功成后|眈眈梵宇深|升堂瞻貌象|默会祖师心
墨子城无恙|公输械有穷|要须能壁立|未可恃梯攻
远树无烟时|前山未云起|晞发临东轩|衣裳半身紫
朝向湖上去|暮从湖上归|渔家自成市|晒网及斜晖
云冻雨无脚|寒凝霜有毛|却能开霁色|爱日炫初晴
使君得佳句|简存如猗那|著之岩石中|千古不可磨
有客从南来|闻是尔相识|曾无一字书|安知我心忆
濯濯泗滨玉|泠泠时一拊|门有荷蒉言|汝心在千古
羸然一老翁|一病一伤和|寒暑不可测|奈此根本何
千思千肠热|一念一心焦|若为求守得|暂借可怜腰
蚕饱办丝课|蜂忙供蜜工|役役为人劳|衣食还自空
瑶草攀春空|衣舄生轻霞|以我尘中目|瞻此天上花
沃野无凶年|正得蹲鸱力|区种万叶清|深煨奉朝食
星斗夜夜光|风云日日改|动静识玄机|泰山见东海
暗去也没雨|明来也没云|日头赫赤出|地上绿氤氲
平分为四序|长得作春看|三友诚高品|兹花一岁寒
青龙不可见|云自洞中出|为雨济人间|归时杳无迹
一夕林中啸|秋声处处悲|天边有鸿雁|相应月斜时
花中藏跳白|出没少鱼惊|向夕鸣榔去|知予是月明
殿前集翠裘|禠奴与奴着|殿上武媚娘|呼谁共谁博
交梨大如斗|火枣围盈尺|缤纷荐寿筵|共映蟠桃赤
凄凉沃州僧|憔悴柴桑宰|别来二十年|唯馀两心在
送君城南桥|笑折城南柳|归来掩关坐|皎月当窗牖
听钟寻野寺|隔树扣云关|鹤卧琴窗静|樵归棋局闲
问寺莫知处|跻攀又溯洄|惟钟藏不密|日暮过溪来
家住天台寺|云岩万丈潭|本来人不识|饶舌是丰干
木头与碌砖|抛出无巧妙|无实法于人|即是我纲要
篱下黄金花|幽人时复采|满天霜露寒|莫待秋容改
满目伤时运|何心傲督邮|南昌有梅尉|同是挂冠休
珠斗城边客|诗才丽绝伦|同心梅与李|共作上林春
白贲谁为偶|黄中自保真|相看经发改|独领四时春
城门踏青草|城下杨花度|荒垄无耕人|三月输官赋
天花落不尽|积满贝多林|可惜谈经处|多从舌上听
涓流归宿坎|暖气动寒泉|影浸梅花月|相看太极圆
奋雄何勇猛|取履若儿童|眇是沙中帝|不如圯上翁
度关人己远|倚剑夜初分|我亦待清曙|前村多白云
路僻轮蹄少|溪深草树齐|春风不解意|花落乳呜啼
昔忧腹不谷|今恐耳生禾|谁向卫公说|翻瓢莫太多
宫阙夜如何|风飘宛转歌|更阑银烛灭|落月在江波
倒橐黄金尽|方悲行路难|桂薪炊玉粒|可是乐长安
坐令簪一枝|蛾眉淡初扫|笑弄黄金杯|连台盘拗倒
曲曲抱寒绿|萧萧趁隐身|频年无俗客|有时来故人
种竹官墙阴|经年但憔悴|故园新绿多|宿干转苍翠
折取三花归|琉璃贮春碧|三十六峰云|昼绕维摩室
仙翁采芝处|只在白云间|童子立松下|日斜犹未还
嗟汝园中柘|虽肥不润身|山东行食尽|无计却秦军
日近长安远|风高易水寒|畏途君莫问|何啻上天难
羲仲司旸谷|涂山佐夏王|六宫师俭德|四海化躬桑
闲花忽开落|尊酒谩相亲|素抱如弗乐|青山不是春
峭茜青葱间|所得亦已足|忽转天地开|锦绣匡山谷
廉耻有微缺|须知孝未纯|白华何所似|所似皎然身
月出烟暝时|水调谁家唱|短棹欲相寻|先经此亭上
三空一不空|悟入势孤雄|得道加殊称|超天自在公
考槃虽在陆|滉瀁水云深|正尔沧洲趣|难忘魏阙心
莫歌冯客鱼|同鄙曹人肉|便作天随生|杞粮而糗菊
久戍在边头|春来忽已秋|雁传天外信|人倚梦中楼
条风将化雨|一夕洒南园|门下多桃李|芳菲总不言
晚有来苏意|忧深望岁人|一犁虽美满|犹恨不当春
爱此沧浪水|临流坐写诗|赋诗元未就|藉水发幽姿
赤壁梦醒时|雨洒玄裳湿|声欲闻于天|故向松梢立
空明比中扃|有本何源源|兰亭修禊事|邈矣羲之贤
果熟山禽伺|园扉早未开|儿童解珍惜|拾取半残来
广袖似云屯|乘风游无际|挹之将何从|逍遥靡所系
寄语文章守|游人去已遥|新诗吟不彻|春兴一何饶
不寐常攲枕|无言独倚楼|江淹犹匪恨|庾信始为愁
重元古吴刹|双桧尚陈时|怅惘临春树|秋风一夜衰
碧绿相差次|红黄迭浅深|化工应自失|雕斲本何心
姜云能损心|此谤谁与雪|请论去秽功|神明看朝彻
白璧埋黄壤|清风忆锦袍|何当絮酒酹|斜日下林皋
造物藏无尽|居然入静观|池吟春草后|荷净倚□看
借问雨中好|何如晴后看|锦江红湿处|应记独凭阑
潮来沙石没|潮去沙石露|士生那无学|学则词章富
浩歌秋水边|惊破白龙梦|明月落深潭|疑是龙珠动
浮生共憔悴|壮岁失婵娟|汗手遗香渍|痕眉染黛烟
杨柳绿堪染|芙蓉红欲然|冥怀与谁契|俯仰共熙然
四溟杯渌醑|五岳髻青螺|挥汗曾成雨|画地亦成河
危亭见上方|林壑带残阳|今日岂无恨|重游却味长
树借看书影|蝉供隐几声|人稀忘屋小|地净觉凉生
五陵花满眼|霜露在草根|冥冥子规叫|重是古帝魂
五月南风起|荷花水榭开|日长消酒渴|碧碗送冰来
巫祝呼神去|缁黄送水还|若非宿来雨|仙圣亦惭颜
栖岩既下集|宾天复上征|八子似荀氏|中当有慈明
弱柳垂新润|春风款款中|濲波飘一晌|绿影过池东
矶头丹荔熟|入手异香闻|日暮红绡退|玉肌持媚君
玉瀣乘旒晚|天浆满珞秋|孟佗消不得|压取换凉州
太行何崔巍|千崖界空紫|异日吴使君|功名亦如此
城东万李树|此树独鲜奇|竟日风开落|无人谁得知
故人如念我|为说瘦栾栾|尚有身为患|已无心可安
并亚陇云飞|稳巢文杏枝|高栖良自得|蜂蝶莫相疑
寿康朝谒蚤|长信燕闲多|不有图书乐|其如昼漏何
瀑花无大小|吹落总成冰|一夜风含冻|草峰雪尽凝
隐隐复悠悠|虫鸣早应秋|夜凉人未寝|草露湿阶头
绿阴欲满寺|禽鸣春雨余|聊因简牍暇|窗下阅僧书
闻道春可怜|春今竟何许|石竹万家烟|海棠三月雨
荷风湖面晓|垂钓柳阴中|何日能蓑笠|扁舟此兴同
鱼鳞息枯池|广之使涵泳|疏凿得蒙泉|澄明睹明镜
古锦裁诗句|班衣戏坐隅|木奴今正熟|肯效陆郎无
乞得栟榈叶|都将当屋茅|青青夸药申|可怕杜陵嘲
春雷忽隐隐|春雪复纷纷|农夫戒及泽|荷锸已成云
劲节岁寒碧|芳枝春煖红|清和夷惠德|千载尚闻风
郎食槟榔花|胜于甜娘酒|槟榔花醉人|且可红唇口
阶远滴成声|荷深圆又碎|风动水银收|亭亭开翡翠
不照魏王车|不填东海水|如何径寸珍|长遗碧山里
尉佗戍五岭|能得粤人心|移书告横浦|绝道恐兵临
荆溪白石出|天寒红叶稀|山路元无雨|空翠湿人衣
可怜地上楼|百姓不知修|上有清使君|下有清江流
愁来生白发|问尔复何愁|应被春光恼|多情雪满头
小舟寻夜泊|明月散风澜|故人相别处|双鹭立前滩
香奁妆欲罢|移照梅花前|徘徊两孤影|抵死镜中怜
秋醪雨中熟|寒斋落叶中|幽人本多睡|更酌一樽空
领得乌纱帽|全胜白接䍠|山人不照镜|稚子道相宜
不策卢敖杖|那张宗测图|神功攒五岳|且作小山呼
盛气劘骚垒|长歌历杜藩|二南四字始|万古一解难
近水观鱼戏|春山独鸟啼|贫交犹不有|何况糟糠妻
晓梦钟欲残|故人枕边别|武夷山上云|白雪楼中雪
五十馀年别|伶俜道不行|却来书处在|惆怅似前生
一方明月影|写在墨池头|昨夜天风起|飒然环佩秋
平生交游间|吾帻盖屡岸|区区稻粱谋|君亦逐鸿雁
山空年岁晚|老气寒峥嵘|耿耿霜月夜|相看直到明
闻道湘妃泪|如何染得成|多应春夜雨|消尽又还生
慈悲与喜舍|历劫自然深|法要无抱束|缘归一寸心
研珠滴露清|自点太玄经|尽日无人到|小窗兰叶青
五月熟杨梅|匀圆如火齐|说似西江人|口角流清泚
渚华初出水|堤树亦成行|吟罢天津句|薰风拂面凉
八珍风味清|藜肠岂曾识|堪嗤尝脔人|欲与鱼兼得
斗牛不能神|枭卢无好采|碌碌甘抱关|谁能媚时宰
暂以碧云色|微笼春月圆|抛人暗香里|误马软尘边
潜心写幽韵|洗耳听寒涛|吟声自摇动|误疑泛鱼舠
赞列词人笔|名闻壮士冠|全才不全貌|莫作野鸡看
公饭何曾接|衣冠不作人|斋中有名酒|分尔一杯春
尺素如残雪|结为双鲤鱼|欲知心里事|看取腹中书
妍丑三千众|恩情一例轻|妾身虽寂寞|天下却升平
海上青琅玕|曾持天上看|萧条风雨夜|谁拾凤毛寒
水疑天际来|声自云间起|耳根本无尘|对此何以洗
猗兰转光风|幽芳被山谷|怅望断金人|同心不同躅
物理窥开后|人情照破时|正如携宝剑|切玉过如泥
二月江南望|桃花烂似霞|人言桃叶渡|桃叶胜桃花
人言妾似花|只似莲心苦|折藕复牵丝|生为多情误
胡霜日夜骄|吹破蓟门月|月色几时圆|待尔照春发
千步更万步|步入白云中|独归里良寺|还望紫瑶宫
滚滚复滚滚|百年如一瞬|秋色入西华|笑嚼新烧笋
逢年要力耕|善舞须长袖|北山休移文|南山归种豆
初画不自知|忽忘笔在手|庖丁及轮扁|还识此意否
屏去竿头饵|非唯用直钩|我来鱼不避|鱼信我无求
龚生来过我|极意论先天|自得环中趣|无言已十年
之子读遗经|青年盛文翰|皦皦丹凤雏|居然立霄汉
延绵不可穷|寒光彻云际|落石早雷鸣|溅空春雨细
五婆山下路|不见五婆游|只有边城水|常涵一镜秋
居然丈夫质|嶷嶷萧艾中|自非铅华种|桃李若为容
空留玉帐卫|那免白头翁|死者长已矣|淮海生清风
生香故触人|异质偶同调|唤作黄家花|弟兄一语妙
朝元高阁迥|秋毫无隐情|浮云忽以蔽|不见渔阳城
令节仍丰岁|宫闱乐事全|千祥并万寿|善颂入薰弦
喧笑攀花会|悲歌怅别期|明年赏花处|只恐动春思
寤寐香炉峰|偃蹇东林寺|朝饮虎溪水|还共天池味
汉帝贵神雀|楚人重山鸡|琅玕不能食|梧桐非所栖
既作湖阴客|如何更远游|章江昨夜雨|送我过扬州
红紫竞芳丛|中蟠一古松|春风自来去|吹不动苍龙
凿翠从阳谷|移来佛屋东|空嵌才一窦|夜与日华通
酌酒繁花外|沉酣预短筇|不为尘俗累|饶有古人风
危石翠如削|影浸澄湖波|六月不知暑|香风生芰荷
昨日杏花开|今朝燕子来|相思三百里|明月在高台
传语通州估|南船甚日还|黄金知易得|留取铸红颜
野旷天明水|风清月在林|孤舟一夜兴|行客十年心
簇蕊风频坏|裁红雨更新|眼看吹落地|便别一年春
西湖天下胜|咫尺安得往|青春不可追|老力亦难强
草窝双树下|借与定僧居|会得虚空境|坐卧总从渠
帝子去已久|楼阁何峥嵘|只见丹青景|不闻歌吹声
好事成长恨|愁人坐雨天|相思无限意|挥泪写诗篇
运水及担柴|无处非般若|如是我闻时|世尊殊不也
人言广寒宫|合种梅花树|那知白玉容|自怕嫦娥妒
士穷见节义|木槁自芬芳|坐回万物春|赖此一点香
飞来何处峰|木杪夜千尺|愁猿唤不应|月色同一白
烈风竖鳄涛|白日江天暝|但闻松柏声|不见松柏影
枯心不作花|仪凤那采取|何当被朱弦|赍身大晟府
万卉春风度|繁花夏景长|馆娃人尽醉|西子始新妆
不晓秦淮水|秦人苦浚之|乱来波浪作|犹似祖龙时
尽道春多雨|伤摧花易空|不知春态度|尤在雨阴中
玉枕寐不足|宫花空触檐|梁间燕不睡|应怪夜明帘
不减阮家会|所嗟当北归|厌厌敢辞醉|明发此欢非
日宫难可跻|月树复惊栖|未听将雏曲|空闻怨夜啼
榴艳对枯筇|西来解后同|折花羞鬓白|未插已颜红
东山云起时|捧日共熙熙|照见子房心|微尔汉皆非
四月桑郊绿|贫家蚕事忙|一筐芳草露|两袖落花香
客去山花落|客来山鸟飞|帘内香如线|山僧云补衣
岩下云万重|洞口桃千树|终岁无人来|惟许山僧住
窈窕如不穷|芊眠足余趣|岂必有云归|自是归云处
寒色初凝野|秋声忽在林|遥山不能见|只为晚烟深
坐把钓鱼竿|虚潭翠如泻|轻舟浮不动|只在松阴下
湘人爱楼居|斜枕湘江起|楼下倚阑人|簪花照春水
主人出家醅|千酌葡萄紫|不问江南人|知是江南水
一灯明古屋|四壁乱蛩声|千里关河梦|五更风雨情
舣棹荻花湾|相期且未还|不须愁日落|明月在东山
故苑花空发|他乡莺自啼|主人孤馆里|斜日楚云西
岌岌穿南斗|层层瞰下方|揭为湖海镇|半夜挂朝阳
万壑接云来|山花涧路开|迎风凉欲坐|啼鸟著人猜
尘匣启菱花|丑妍无不识|羞杀几英雄|霜髯太煎逼
事道宗尼父|谈仁法孟翁|圣贤无二道|千古此心同
迢递投前店|飕飗守破窗|一灯明复暗|顾影不成双
月过蔷薇架|雕鞍未到家|小娃犹𣨼酒|拦路夺人花
樗栎虽不才|亦各言其长|愧此万丈夫|寐卧无何乡
衣拂京洛缁|窗含齐鲁黛|因君思故山|驱车火云外
夜气散清空|扶桑曙日红|普天皆仰照|鸣凤在梧桐
暮齿无筋力|嗷嗷哺众雏|缅怀皇甫冉|尝劝陆潜夫
掾曹官事了|载取曲生来|得酒且欢喜|俗氛安在哉
握节汉臣回|麻鞋见天子|感激动四极|壮士泪如雨
物外溪山乐|穷中岁月优|斯人招不起|十顷稻田秋
眺望觉日迟|经过忘前后|牧唱儿童闲|黄牛满丘阜
群卉枯落时|挺节成孤秀|既保岁寒心|不在遐年寿
洒尘成细迹|点水作圆文|白银花里散|明珠叶上分
梅花亦何奇|偏便幽人爱|清寒风雪夜|一枝静相对
郢客何方来|为君鼓瑶瑟|席上走楚云|杯中落湘日
相去忽已远|不知山北南|祗随流水入|尽处是龙潭
披衣起遐征|微茫认前路|哀鸿天际云|残月水边树
江上灵妃过|秋风响佩环|骑龙向何处|只在九嶷山
苹藻绿依依|鲜鳞跃处肥|江湖宜适意|切莫近渔矶
禅榻一觉睡|冬宵五更长|窗递清风入|枕边松柏香
独坐桂花边|清香杳杳燃|夜深山寂寂|明月满西川
三城去三山|沧波三万里|仙子时来游|印下西山履
游骑来逢雨|宁全是折磨|山神应洗路|恐惹俗尘多
侍从才今几|君王宠正初|常州何处是|头白小孙孤
短鳖兼穷细|屁勋青黑同|只好留墙壁|何须问主公
江南仲秋天|鲟鼻大如船|雷是樟亭浪|苔为界石钱
何处清风里|长松古县门|海风吹不断|明月满乾坤
人禀五行秀|卓然与物异|由其达大经|秉彝不容己
此地蛟龙伏|中原蛇豕多|借君白羽扇|万马饮黄河
曾向山中住|黄花烂漫栽|主人缘爱竹|三径不教开
苦心日宛转|九原竟寥寞|服尽泪随尽|此道今人薄
鬵釜吾已溉|吾缨亦无尘|洼石以潴之|恐有抱瓮人
炊烟连断霭|隐隐见松亭|亭中有静者|单读净名经
旭日波光动|精蓝曙色开|美人多逸兴|吹笛过湖来
此别意何如|人来即寄书|圣恩无远近|随处是安居
溪莼牵紫丝|念子良已久|不在秋风前|不在秋风后
古苔隐石色|寒花明药丛|有时白涧雨|终日青松风
落日松风起|还家草露晞|云光侵履迹|山翠拂人衣
万叶烟云上|千花锦绣中|停舟不忍发|为恐破圆红
黄鸟衔青虫|径飞入深箐|蛱蝶绕墙飞|相逢不相见
曾约还康山|披蓑共春锄|东林缚我屋|西崦置子庐
城隅采桑地|车马日缤纷|自恨轻来往|何当怨使君
寒逼禅僧定|凉醒醉客眠|户枢从不蠹|岁月任推迁
冥冥江雨飞|冉冉江云细|何处见春华|蘼芜满幽砌
青镜不容丝|妍媸照自知|朱颜与白发|相去不多时
楼外青山好|楼前绿树多|阑干知几曲|曲曲费吟哦
采来灵壤内|爆向广庭前|修制成良剂|为□到十全
薄采潇湘骨|寒天障物华|世珍云母石|我爱款冬花
山色青于染|松阴扫未开|水边芳草地|才见两人来
野笋无料理|惟宜贱子餐|若教都作竹|约略百来竿
一阳未嘘枯|霜木醉梦里|照眼忽横枝|令我折屐喜
眷此青田鸟|相看意未欢|共期齐六翮|大叫出云端
二月垂杨岸|行春诗酒徒|苍头前引道|拄杖挂葫芦
涧浅山四合|泠泠浸青青|略彴度前林|更有泉上亭
衔祸口边冲|时间祸必逢|古人称是病|焉敢不言凶
苍然百丈峰|峙此一池侧|遂令活水源|长含太古色
儿时射鸟鼠|稍长射狐兔|生长牛羊中|肥白亦如瓠
野竹编篱细|山泉灌圃浑|碧瓜方布子|紫芋更添孙
逢君竹西路|送客茱萸湾|玉手摇兰桨|琼波写雾鬟
花解冲寒放|将同白柰栽|粤人浑未识|呼作贺正梅
绰约孤亭中|梅花斗清绝|高天一万株|乱洒罗浮雪
海上琅玕石|山中翡翠毛|意含秋雨润|思拂暮云高
展卷嗟丘也|东西南北人|昔还行脚债|今作卧游身
烟云供惨澹|霜露觉萧森|篱菊知饶笑|秋山一片心
当年陶埴意|祗为美人工|转见文坛重|俱称自邺中
丹蕤攒宝相|此种贺州来|千叶滇南白|都非越客栽
怀橘悲何及|芸瓜老不任|摘来先庙祭|洒泪向松阴
散步瑶阶下|庭空不见人|回头顾明月|惟有影随身
客欲谈世事|词锋若戈矛|我已梦为蝶|咄哉为罢休
暝树含苍霭|春云散碧空|如何幽涧鸟|啼向月明中
数日相望极|须知意思迷|梦魂不怕险|飞过大江西
淝水萦如带|淮山崒似云|此时闻鹤唳|无复畏官军
一笑鹘搦兔|终朝獭祭鱼|秋闱与春试|却用郝隆书
与君为近别|不啻远相思|落日平湖上|看山对此时
浩浩中天立|如何是丈夫|乘槎须远去|不买水精奴
蕴玉抱清辉|闲庭日潇洒|块然天地间|自是孤生者
帝里春无意|归山对物华|即应来日去|九陌踏槐花
世路关山险|闲门秋雾深|如何一杯酒|不与古人斟
次第竹根泻|相将得到家|鸟啼春雨后|流出满山花
含情笑不言|政是多情处|参得个中禅|此事尝分付
手种忘忧草|都缘耐老亲|今年花又发|不见白头人
数漏掩残历|中宵气候殊|独怜愁共病|不与岁同除
春风冷落后|秋圃恨开迟|总是宜男草|傍人也未知
堂上论文客|异时还索居|池中鲤鱼足|好寄别来书
晚岫带霞明|汀洲变苹绿|如何万里桥|却在苏台曲
青天归雁喜|密树坐莺深|落日春愁里|怀人浩荡心
已讶雪中在|况逢灯下看|酒阑相把赠|疑是翠琅玕
慈孝相感激|天机谢人力|谁来石下歌|见母不见石
两京四十载|迢递梦家林|萧散五君咏|山王空愧心
深居白云穴|静注赤松经|往往龙潭上|焚香礼斗星
青山映檐低|绿树出云齐|何处长安道|纷纷过马蹄
山都洗我觚|贮月饮涧下|风来吹有声|笑学昔人挂
旭日出旸谷|曈曈曙色佳|重门浑未到|先到读书斋
暮霰袭吟袍|夜火然枯竹|盎然坐春和|炉香芋初熟
汲水洗石床|上有唐时字|不用太兮明|恐损莓苔翠
憔悴远归客|殷勤欲别杯|九星坛下路|几日见重来
青山日相对|闲看白云生|谁谓无心出|中含济物情
屏居湖上村|相携尘外侣|看竹过邻家|不问谁为主
玉烛重开岁|璿杓复建寅|谁知康寿殿|四序只长春
竹柏影参差|正市长桥下|何处无月明|谁似予闲者
湖山重到日|风景怅当时|越客清江上|犹吟吊鄂诗
宝坻产嘉鱼|纤纤白似银|贡来供玉食|何意得尝珍
五季骄诸镇|终朝易千人|使无孔方癖|犹是晋名臣
古木不知年|差儗南华栎|此地非曲辕|无劳过匠石
鸠鸣桑雨深|蓑笠耦耕叟|短歌三两声|东风动杨柳
马饮人血肥|生臕毛润泽|杀人但取血|肌肉成糟粕
雨馀芳草绿|石尽野塘浑|落日一声笛|断肠人倚门
心贞如玉性|志洁若金为|托赠同心叶|因附合欢枝
植杞必植梓|艺兰仍艺荪|过庭遗训在|凿楹故书存
风雨劳先别|敢辞樽酒深|一梢墙上竹|留作岁寒心
峰势若簪云|云根何太低|记得文登路|如绵衬马蹄
散策下亭阿|水清鱼可数|却上采菱舟|乘风过南浦
天风来广寒|吹下云锦裳|虽无金错刀|缇革余敢忘
绝爱墙阴橘|花开满院香|邻人欺不在|稍觉北枝伤
旅思又惊夏|庭前长小松|远峰生贵气|残月敛衰容
临水望梅崦|却指敖城路|路直本如弦|江行自回互
饭颗从嘲瘦|湘流独占清|失身到东阁|聊复对簪缨
怜桃及桃叶|爱柳及稊荑|但渡无言苦|兰桡我自持
日夕歌声起|前村带雉归|如何牧犊子|不惜雉朝飞
胜日罢书经|扬舲出远坰|清流兼峻岭|应不减兰亭
上下五千年|纵横三万轴|高凭百尺楼|远送乾坤目
爱日经檐煖|游蜂扑纸窗|吾生岂拘束|一笑俯涛江
濯足倒流水|回头相见坡|马嘶人又倦|落景在烟萝
实际即为诚|中庸说著形|晓来雷雨过|七十二峰青
西斋君去后|别绪乱于莎|乃知长笑语|始奈客愁何
允中不允中|中在虚无里|无在无无在|自见天之理
深院闭青苔|黄昏独自来|花应怜我意|特放一枝开
君生我未生|我生君已老|君恨我生迟|我恨君生早
翠实连千亩|扶疏荫绿苔|秦台骈月管|应有凤凰来
曦射窗烟破|风飘花露寒|莺声清梦觉|春色独凭栏
学诗不能神|得句常草草|傥可寄吾怀|岂必人称好
高柳收帆处|平芜纵目馀|都将今古兴|尽向驿楼书
挥手谢小儿|吾欲观大化|当尽便须尽|何用复悲诧
黄鸟昼阴寂|白鹅春草青|高轩如可借|著我学黄庭
西林贝叶编|东林竹叶酒|问我西来意|翻云醉中有
扇题归去来|客遇潘渊明|举扇谢佳客|归耕吾已成
佛爱我亦爱|清香蝶不偷|一般奇特处|不上妇人头
骏马碧玉蹄|遨游洛阳道|思君君不归|无复关春草
偃蹇歌招隐|栖迟老岁华|世情从燕雀|吾道自龙蛇
无复尘劳梦|犹蒙故旧知|宁辞万钟禄|不负一纶丝
春归南浦早|渌水桃花塘|灼灼红烟里|金羁骑玉郎
风吹峨眉云|东依此山住|我来不敢登|只恐还飞去
簿领乃俗士|清谈信古风|吾观苏令绰|朱墨一何工
思家千里梦|恋阙万重心|欲去频回首|烟霏满上林
露气横疏柳|香风送晚荷|不知潮面阔|止觉四山多
曾参回胜母|墨翟避朝歌|无限功名子|狼村日暮过
江海翱翔地|舟行岸自移|无心波浪里|鸥鸟不须疑
四境静山川|一枕闲风月|野水抱城幽|青天垂木末
飞瀑涌寒峡|流云静幽壑|夕日倒峰影|杯中双剑落
沙头捕鱼艇|朝出晚未还|不如洲上鹭|闲立看青山
中嵩太乙南|岩竹风犹扫|长镵吾欲来|为君种朱草
莫问我姓名|向君言亦空|潮生沙骨冷|魂魄悲秋风
茆屋依山构|沿村路不遥|酒旗标野店|有客过溪桥
叶逐散声飞|湘云隔妓衣|谁能偷卷看|认是小丛非
塞上亦良夜|明月本无心|照衾复照面|一一感人深
秋意入梧新|独居怅远人|芳樽吾负汝|清昼坐伤神
莫年生计违|头白独如期|争似儿童日|渔樵逐队嬉
疏星冻霜空|流月湿林薄|虚馆人不眠|时闻一叶落
山势西来断|江流北去平|万家深树里|闻是吉州城
当轩弥滉漾|孤月正裴回|谷口猿声发|风传入户来
自有两山来|几人此经过|青山默无语|识人知最多
司晨兼五德|曾伴宋宗窗|日攘能防慎|终当免镬汤
激浪闻澎湃|山神阴力多|风涛归指顾|海若敢谁何
乃祖宽仍豁|曾孙察作明|不将囊底智|分减及元成
华月窗间过|凉风扇底生|抚时追往事|幽恨不分明
舴艋小于杯|鲈鱼肥似瓠|故人如可来|沽酒芦花渡
青云乔木古|翠竹远山青|昨夜东风暖|池塘草未生
睡少秋难晓|吟多食愈贫|南柯无近阙|差尽梦中人
骑虎度诸岭|入鸥同一波|香寒明鼻观|日永称头陀
晚来新雨过|忽忆枕边书|睡起推窗看|茅檐月上初
持酒濯利剑|青蛇光黯然|金鞭鞭骏马|汗血沾锦鞯
寒蛩不可听|况复起清砧|落叶将飞雨|潇潇又满林
种尔酬佳节|节过开尚迟|纵令迟更好|争似莫愆期
口说遍河沙|毛发不得力|人即任君欺|君欺君何益
二鸟占丛竹|喧啾春雨时|朝阳有鸣凤|栖老碧梧枝
孤馆灯初暗|虚窗月正明|寒衣犹未补|风递捣砧声
不逢圣人时|不见圣人面|圣人言可闻|圣人心可见
五马骤从东|桑中无路通|使君休调笑|君妇恐如侬
两崖交翠阴|一水自清泻|俯仰契幽情|神襟顿飘洒
橘大天地窄|眼高秦汉小|一片隐沦心|商山青未了
海静不扬波|仙人鞚鹤过|灵峰七十二|何处月明多
遥羡青云里|祥鸾正引雏|自怜沧海伴|老蚌不生珠
屈原沈江死|扬雄投阁生|一时生死计|千古是非名
天孙织玉帘|悬之千仞石|垂垂不复收|滴滴空山碧
偶上千峰榭|因思小范公|桐庐萧洒处|尽在十诗中
客持一卷书|乾坤吐玄秘|由来识者稀|独立寒山翠
荒水浸篱根|篱上蜻蜓立|鱼网挂绕篱|野船篱外入
一棵老梅树|两个大桠叉|未结黄金果|先开白玉花
芒鞋青竹杖|自挂百钱游|可怪深山里|人人识故侯
冲市柴鱼集|应山鸡犬号|问知人苦乐|米价不多高
孤亭十尺藏|梅花万株列|中有姑射仙|肌肤若冰雪
江门白藕花|我榻庐山顶|君若去茶山|茶香复谁领
箕踞长松下|溪流如白云|美芹采南涧|可以奉吾君
去岁一杯酒|遽然生死分|儿孙为寿地|恸哭不堪闻
不饮红裙酒|祇将文字论|江东渭北客|日日对芳尊
折桂桥尚存|折桂人已矣|时有桥畔人|拾得桂花子
到此无俗客|何妨款竹扉|山花能作供|林月送将归
寂寂空山里|春和草自芳|隔溪人不见|髣髴唤刘郎
游人武陵去|宝剑直千金|分手脱相赠|平生一片心
黄叶万山秋|白云千里暮|高楼明月多|怀人在桑户
何人不相识|斗室傍城隈|闻有不平事|轻身半夜来
南土殊风气|冬林叶尽丹|越天无雁度|楚泽有龙蟠
丁与水同宫|王将耳口同|尹来居口上|山岫获重重
挥汗欲成雨|聚蚊真若雷|山翁在何许|赤脚步溪来
壮士不曾悲|悲即无回期|如何易水上|未歌先泪垂
无华真国色|有韵自天香|临风难自持|为舞白霓裳
北苑今仍在|南宫奈老何|青山解浮动|端为白云多
无限停云思|悠悠兴欲飞|仰看向南鹊|绕树竟何依
城市或嚣炎|在野心不热|意欲施茶汤|行人他处渴
巉然千仞峰|宛似九苞鸟|神游乘兴时|骑上青云表
池馆临丘壑|泉声落座隅|林间逢隐者|端坐说唐虞
向来与相国|投分自钟山|不入翘材馆|甘为老抱关
昔骑五花马|今跨一黄牛|岭上猿声叫|焉能止泪流
雁还空渚在|人去落潮翻|临水独挥手|残阳归掩门
今日汉家子|谁非粪上英|琵琶弹马上|哀怨莫分明
艳夺晚霞红|繁开细雨中|何如庭下竹|孤节傲霜风
夜半霜铺瓦|浑如水泼衾|炉红朝易起|衣重老难任
客来打秋风|我赠秋声集|要知此书名|预先为我立
高歌激宇宙|岁晚寸心违|忠贞负冤恨|奸雄多是非
燕忙将水撇|鱼乐欲空跳|此意谁能会|光阴静里消
放舟山水间|舟上载青山|薄暮临溪坐|青山相对闲
夫节独高古|妇贤传至今|既为加美谥|复不用邪衾
青山多白云|佳树杂芳植|伊人不可招|关路日已夕
冷落茅檐下|残釭剔半明|梅花瘦比我|窗外影交横
薄俗易炎凉|浮云屡更变|耐久屋外山|相看无厌倦
碧草通樵径|青松夹寺门|已来亲眼见|难去对人言
紫藤挂云木|花蔓宜阳春|密叶隐歌鸟|香风留美人
花径呼童扫|柴扉为客开|忽惊仙犬吠|云外一车来
玉镜初开匣|嫦娥露巧妆|天西新样子|传与画眉郎
碧树含秋色|飞泉急晚声|不知谁领得|惟有野人情
层岩值幽芳|孤根掩丛棘|何来独嗅人|不藉薰风力
晚叶似朝雨|蓼花如醉翁|那能当此夜|又听一声鸿
岂计身封宋|祗愁祀绝殷|不惟称克孝|亦自有三仁
高深极前临|苍莽接回眺|齐州景物多|于此领其要
物微深可悯|畏雨复兼风|适见传呼宠|俄成扑地空
秋风天外声|明月江中影|幽人把桂枝|露下衣裳冷
长夜一灯灺|独愁谁与言|窗前几点雨|井上芭蕉翻
为报庐陵客|逢人且寄声|不知无恙否|何日到南城
前辈经行处|壁间题小诗|梅花还好否|要见出尘姿
昨日游醉乡|今朝涉汝水|回首岘山城|萧萧乌桕树
杲杲东出日|万方被照临|鸲鹆不逾济|草木有常心
结庐在中林|因以消尘虑|棋枰与酒斝|幽人自来去
片雨从西至|开门爽气侵|蝉声似溪水|流入野人心
湘山千岭树|桂水九秋波|露重猿声绝|风清月色多
千丝复万缕|向儿臂上缠|教儿长寿命|一寸一年年
静夜闻林雨|山灵似欲留|只愁梯石滑|不得到峰头
性定离交坎|心澄木并金|四般归一处|全在洁庵成
瓦瓶担山泉|石鼎煮岩菊|燎以松桂枝|清芬满茅屋
号名极形似|摹写与真逼|聊以画滑稽|慰我秋园寂
翠蔓缘株上|红芳冒暑开|凌霄诚有谓|托质岂无媒
左氏讥怀璧|杨公却袖金|安知机巧者|藏得叵罗深
飞飞复飞飞|双起复双栖|料得影相似|怪他蜂亦迷
未读书中语|忧怀已觉宽|灯前看封箧|题字有平安
自从有天地|人事几迁改|更过百年期|今人谁复在
花时去贩茶|叶落未还家|寄声船上月|慎勿照琵琶
貂珰窃大柄|韦布献孤忠|榜出惟风汉|无名在选中
骏马在异骨|权奇插面高|人间那乏此|难遇九方皋
天晴钓丝短|天雨钓丝长|但求滩水满|不用鲤鱼尝
惊马吹悲篥|边风助苦声|城南有思妇|梦里听分明
十年不平事|未肯分明说|夜半枕吴钩|含悲啸明月
于菟啸空山|万窍寒风出|堤防飞将军|汉箭有神物
背我堂堂去|随他昔昔来|无情犹有恨|独上望春台
嫣然一株花|媚此庭中幽|翻觉此名赘|人生何所忧
儿童爱春懒|为买汝南鸡|不晓幽人意|翻令拂曙啼
尔幸无羸角|何用触吾藩|若是升堂者|还应自得门
山月缟中庭|幽人酒初醒|不是怯清寒|愁蹋梅花影
绿叶霜中夏|红花雪里春|去马不移迹|来车岂动轮
圣主方思治|边臣未奉行|凭君达此意|无得负苍生
谁令珠玉唾|出彼藜藿肠|仁人不为宝|良贾宜深藏
夜静水空清|冷轮彻底明|谁知潮长落|长伴月虚盈
黄鹄毋爱饱|那怕人间网|不夸羽翼长|但夸天地广
旸谷宾初日|清台告协风|愿如风有信|长与日俱中
初随林霭动|稍共夜凉分|窗迥侵灯冷|庭虚近水闻
苍官森古鬣|此君挺刚节|中有调鼎姿|独立傲霜雪
季心何意气|夜半犹开门|幸免穷途哭|能忘一饭恩
萧骚复萧瑟|非筑仍非琴|天籁本无作|澹然千古音
写就相思字|灯前带泪看|欲缄还未忍|少待泪痕乾
尊酒贪迎月|人生醉后佳|夜来窗不掩|吹落一瓶花
林深堪驻马|鸟宿不惊凫|坐遣花间月|慇勤上玉壶
国色原无匹|天香况出群|洛阳春一种|犹值五千文
夜月玉堂前|春风紫盖边|想君都看破|宁与我周旋
色变莺雏长|竿齐笋箨垂|白头身偶在|清夏景还移
篙痕看尚在|舟去已何之|任是沧桑变|丹丘故不移
繁阴乍隐洲|落叶初飞浦|萧萧楚客帆|暮入寒江雨
礼岂为我设|如伤风教何|不堪睎阮籍|直欲刃韦高
粲粲初投米|飘飘旋落花|巷深迷吠犬|林合误归鸦
万里无归耗|形将一木亲|遗言入肝肺|真得太夫人
娟娟春前花|袅袅风前柳|独有此君子|可为岁寒友
一碧涵天光|八牖开玲珑|观水观其源|千古在目中
花老几人来|人老花常少|安得似花人|年年陪一笑
怕见人言老|梳头夜二更|谁知灯烛夜|漏逗愈分明
闻道珠履客|今朝黄绶归|定知高士贵|一府莫言非
晓起但焚香|烹茶更扫石|俗家应不来|琴书吾自适
淮阳谁可傅|无以易元成|即汝佯狂意|为王言事兄
风尘难自料|花鸟故相猜|问是山东客|何由万里来
离樽闻夜笛|寥亮入寒城|月落车马散|凄恻主人情
粉翅嫩如水|绕砌乍依风|日高山露解|飞入菊花中
长物不随身|周游信双屐|中天泰华云|绝顶蓬莱日
承诏辞金阙|衔悲入塞城|可怜沙上月|浑似汉宫明
石色凝秋藓|峰形若夏云|谁留秦苑地|好赠杏溪君
渺渺蒲江远|年年桂树秋|空馀诗卷在|天地与长留
从此西行去|春风处处花|沙弥留碣否|乱石拥残沙
低头看明月|仰面贪归鸟|庭前白露下|已湿青鞋了
不逐风云去|盍求山泽安|祗怜当笔者|空作画屏看
看竹不问主|听松还对僧|山中春欲暮|此兴复谁曾
意亦心所至|言须耳所闻|谁云天地外|别有好乾坤
主人能载酒|客到卧林园|松风和竹影|相对水禽喧
石钟以声名|无声安取此|风水月明中|我忆东坡子
有钱但沽酒|莫买南山田|勾引催租人|惊散青松烟
燕门城似铁|太行石为碣|征人一骑还|何处关山月
江险不容极|禹功胡可忘|向来小龙子|衮冕食千羊
寒灯伴吟久|夜深微欲灭|孤客未成眠|尚惜红蕤结
一霎荷塘雨|明珠翠盖擎|柄危难得稳|稍侧便须倾
日永篆烟消|风寒襟袂薄|闲窗无客来|坐久庭花落
屈折金石瘦|偃蹙虬龙怒|萧然少生意|端为根中蠹
晴天暗暗雪|来送青春暮|无意似多情|千家万家去
龙起雨方注|虹横瀑更飞|谁令丘壑士|无意恋荆扉
浓碧荫清漪|可能不流睐|钓自不得鱼|得亦不肯卖
怪石凝云气|横枝浥露香|故人渺何许|秋意满潇湘
一径净于秋|山中夜来雨|倚松不知还|幽禽妙言语
紫烟浮碧虚|炉峰几千丈|欲持一瓣香|安得仙人掌
山光与溪色|一碧泻云中|倚槛久未去|更听松上风
客到暂冠带|客归还上关|朱门客如市|岂得似林间
说破无为趣|玄关奥且深|欲求天上宝|先觅水中金
只宜滋淡泊|安足奉膏粱|食肉非无辱|何如此味长
道院今犹古|闲中事可书|鹭鸥驯不去|谁可得亲疏
澄少危加杖|平肥亦食糠|刘郎豁如者|轑釜未能忘
风顺月仍明|扁舟半夜行|鸡鸣问前路|巳近九江城
妾泪非易弹|乡关渺千里|世事与愁肠|相对何人语
三生空有石|三竺未成赋|徘徊九里间|吟情拂高树
鸡雏不离母|离母声不休|如何宦途人|岁岁天边游
良机间不作|成事每相因|善处囊中颖|知非碌碌人
东坡龙井回|题名塔砖上|岂期后百年|过者为瞻仰
客心惊落木|夜坐听秋风|朝日看容鬓|生涯在镜中
静中见万物|各各有春意|收拾入襟怀|阳和散天地
军中始吹角|城上河初落|深沈犹隐帷|晃朗先分阁
我有一片心|不说君应知|前山好明月|赠君云尽时
大隐隐于酒|小隐隐于竹|何不呼曲生|来同此君宿
绣窗同刺绣|女伴喜天晴|剪刀当日暖|妆镜隐霜明
橙色似黄金|佳名最为贵|一腹饱秋霜|尝之有馀味
清风起乔木|虞麓浣花庄|老我成长望|平安字数行
激曲萦飞箭|浮沟泛满卮|将来山太守|早向习家池
留连非鱼鸟|溯洄岂蒹葭|明月浴灏露|青云汲流霞
花拥山头白|云翻日脚斜|银蟾已照路|游客莫思家
罗汉十六轴|江僧寄此山|画称天下绝|人自定中还
妾身如乱丝|卷藏箱箧底|愿上鸳鸯机|无人为分理
空林露华湿|开阁徙清尊|月出芙蓉水|风生鸣鹤园
知有前期在|欢如此夜中|无将故人酒|不及古淳风
巍巍孤高亭|念我昔所喟|子也时一登|千载起立志
太守政何如|兹焉名可见|齐州一万家|挥以袁宏扇
阴能间其疏|竹可扶其弱|点缀自天然|讵须金孔雀
江湖各相忘|鱼虾同一波|谁能写此妙|徐白名不磨
兄也错到底|犹夸将相才|世缘何日了|了却早归来
候鸟解鸣春|呼晴复呼雨|朝耕一垄云|夕息三家墅
衔杯何处好|风月临江美|为问江上翁|赏心竟谁是
平生性好奇|作字亦如之|老去归平澹|时人应未知
春梦复春梦|春梦有谁醒|昨日梨花白|今朝杏子青
静里三三昧|多年得效方|不知缘底事|动辄叹龚王
幽斋只数椽|科头抱书读|经旬不出门|芳草上阶绿
石煖苔衣软|溪春荇带长|化工无限意|袖手立斜阳
化成真化出|绝险起朱栏|直下临无处|江城一掬看
阴壑鸣松籁|空岩响石泉|此声并此意|谁得寄徽弦
白日下深沼|游鳞动腥风|宛有川上趣|不羡濠梁翁
竟日碧山中|清宵憩宝宫|客愁无那处|一叶已秋风
沉沉卧虹底|小阁贴平湖|鱼戏几堪掬|鸥驯欲就呼
秋风一夜至|吹尽后庭花|莫作经时别|西邻是宋家
旷野风沙晓|崇丘灌木墟|地犹沧海郡|人上太平书
故人惟汝在|不道是瑶华|香外无知己|氤氲自一家
高吟水木净|逸思风云骤|知有沧洲期|意得还独笑
锦棠天与丽|映日特妖娆|五色绚仪凤|真堪上翠翘
溪山疏雨歇|水木散清阴|樵唱知何处|白云深更深
露彩莓苔碧|天香桂子丹|多应广寒夜|流影落人间
守相卿耆旧|相逢必霁威|渠宁私邑子|汝勿视翁归
九月桃梨树|花开满故枝|寄言车马客|不是艳阳时
天高群水落|寒至老梅开|般若无文字|何人上讲台
种柳连庄屋|春来色更娇|不同残腊见|封雪落长条
马上风尘倦|登舟似到家|雨晴凉意足|含笑对江花
昔日徵黄绮|余惭在凤池|今来招隐士|恨不见琼枝
屏开山弄巧|岩秀壑争流|漫作剡中梦|难寻雪夜舟
强惜数茎须|惟愁白却渠|朝来都白尽|愁惜两何如
天回金气合|星顺玉衡平|云生翡翠殿|日丽凤凰城
昔进温成御|惟闻自吉州|荔枝天下品|曾掩玉环羞
木人岭上歌|石女溪边舞|明月共同途|无私照今古
桃李莫相妒|天姿元不同|犹馀雪霜态|未肯十分红
梦里寻音响|教休定不甘|忽知眉盖眼|开著替人惭
昨夜春风生|吹送瑶台雪|为君展玉琴|高调石上月
有山静而秀|有水清且漪|风霜空宿翳|草木含幽姿
人鱼不相及|挂颊以香饵|因循十年错|归计觉今是
家住凤城南|门临古陂曲|时怜上林雁|半入池塘宿
贞士不可见|或从林下逢|暂即松筠室|聊怡冰雪容
迟日转轻阴|惊风发疏冷|何处斧丁丁|千山白云暝
遥看沧海城|杨柳郁青青|中央一群汉|聚坐打杯觥
莫以容颜丽|偏忘明主恩|当年不召幸|辛苦在长门
细路何盘折|重经碧藓封|钟鸣知寺近|只隔数重松
闻君佩玄珠|明月终夜朗|莫作江湖游|白日愁罔两
六出混五出|皑皑迥无异|消融让结实|调羹功及第
新霁飏林初|苹花贴岸舒|故乡今夜月|犹得照孤庐
远羡五云路|逶迤千骑回|遗簪唯一去|贵赏不重来
道格何曾格|言糊又不糊|浑身总是眼|还解识人无
苍苍竹林寺|杳杳钟声晚|荷笠带夕阳|青山独归远
平生本多思|况复老逢春|今日梅花下|他乡值故人
神妃游洛水|照影弄晴晖|明月沉珠佩|香风动羽衣
庭树清阴满|园林翠色交|数竿春雪重|摇折紫云梢
五月黄梅候|家家望插青|空斋无雨过|愁绝闭柴扃
玉女乘烟雾|松间采薜萝|飞行了无迹|明月送空歌
一种貌如仙|人情要自偏|罗敷有底好|最得使君怜
世上痴儿女|争趋乞巧筵|妇鸠甘抱拙|不谄鹊桥仙
雨歇荒鸡叫|山空木叶堆|玉堂云雾景|多向此中来
因读古交篇|乃知郈成子|心逾两无言|今日谁能此
取醉非无酒|忘忧亦有花|暂来疑是客|归去不成家
诵公十妙语|便觉舒华年|意与境俱会|超凌心欲仙
高议排山岳|典刑犹乡土|我来瞻拜馀|花竹映庭户
谁写青田质|高超雁鹜群|长疑风月夜|清唳九霄闻
楼西鹦哥树|单栖铁鹦哥|儿童作蛮语|花鸟入滇歌
兴来飞画舸|泛泛水中凫|绿皱移歌扇|红鲜迓酒壶
伫立望钟山|阳春更萧瑟|暮寻北郭归|故绕东冈出
黄门执戟翁|晚乃薄词赋|我宜草玄文|未必知妙处
小盖行障日|枯筇立倚风|入田催种稻|行圃看浇葱
手圈杨柳枝|出门送君去|柔肠暗相结|宛转无尽处
雪洗桃花面|烟描柳叶眉|与春同是梦|安用赏春为
一夜江蓠花|乱吐山房侧|唤取汨罗人|窗间弄秋色
山似琅玕小|地将秦望雄|越王歌舞处|长作梵王宫
越女收龙眼|蛮儿拾象牙|长安千万里|走马送谁家
古木上参天|流云下拂地|山亭人不来|老鹤自幽意
垆头聊潦倒|斗酒可谁相|燕赵逢游侠|怀中匕带霜
翡翠随潮月|琉璃共佛灯|沉香闻远远|珠树间层层
潇湘万顷秋|淇园千亩绿|幽玩何须多|一枝清已足
夜久尘虑息|泠泠寒风生|长啸望山月|颓然与道行
地静偏宜晚|舟轻不怕潮|身心两无事|随处足逍遥
秀木千章倒|层甍万瓦差|悄无人似玉|空咏小戎诗
风劲香逾远|天寒色更鲜|秋天买不断|无意学金钱
浮云世事改|孤月此心明|咏叹坡公句|凄然百感生
蛩馀窗下月|草湿阶前露|晚景凄我衣|秋风入庭树
高台久已倾|蒿蓬纷簇簇|犹存龙虎名|常散牛羊牧
无语与花别|细看枝上红|明年又相见|还恐是愁中
船板胡在兹|而我寝其上|情知非江湖|梦寐亦风浪
蛮徼缠妖气|王师蔽海𣸣|君看旗旐举|白昼起风云
烟树横一抹|微茫混天色|林疏见夜灯|点点讶奎壁
一水泛秋光|千山共夕阳|江乡无限好|都属钓鱼郎
庭阴双树合|窗夕孤蝉吟|盘礴解烦郁|超摇生道心
野水平溪桥|波翻蓼花乱|斫竹编青篮|门前开蟹簖
本为情沈饮|翻成病染身|今朝高枕处|应羡独醒人
马上春如梦|空嗟岁月长|天涯无限路|芳草自斜阳
云尽天容静|冰轮故故圆|广寒宫阙里|今夕是何年
为爱江南竹|春深叶渐交|谁家三径里|残雨出横梢
老朽归田久|鸟纱白发新|经纶天下事|都属少年人
桂水饶枫杉|荆南足烟雨|犹疑黛色中|复是雒阳岨
问讯阶前菊|如今属阿谁|祗应风露底|犹记摘残枝
早已逃俗类|从今始清绝|皎皎不可侵|如看海□月
若为逃世网|却订钓名钩|自是惊飞尽|群群海上鸥
自出梅关外|江山非故乡|梦魂不怕远|夜夜到隋冈
水淡珠多白|水咸珠多黄|月光化为水|来养明月珰
风雨过苍峤|秋色渺江海|白鸥期不来|沙上人相待
底事洪泽壁|空留黄绢词|年年淮水上|行客不胜悲
堤长交柳荫|桥狭束荷香|掩户回逋客|凭栏狎漫郎
虚心秉高洁|不受一尘侵|五月清溪上|萧萧风满林
四山敛暝色|百虫沸哀声|夜久月未出|川光虚自明
挂帆涉沧波|瞬息三万里|蓬莱有会期|莫为风雨止
栽培万杉树|延纳五峰云|莲社松门接|陶居柳径分
绿藻盈盈动|朱鳞两两俱|悠然相乐意|何处是江湖
初更催县鼓|倒履迓仙槎|细雨销红烛|连床语白沙
参芎自不恶|藜芦亦何尤|丈夫同气味|白首愿同游
渡水采桑归|蚕老催上机|札札得盈尺|轻素何人衣
谓我不如斯|人其谁我谅|是何人之殉|不怜我之丧
晓听枫桥钟|暮泊松江月|斯人亦可人|淡墨写愁绝
东西是长江|南北是官道|牛羊不恋山|只恋山中草
晨钟殷晓窗|明月窥独坐|幽阶风自来|芙蓉淡如我
风驶柳条乾|驼裘未胜寒|慇勤陌上日|为客暖征鞍
溶溶溪口云|才向溪中吐|不复归溪中|还作溪中雨
滔滔大江水|天地相终始|经阅几世人|复叹谁家子
江南云水乡|蓟北冰霜地|由来岁寒心|不以移根异
阳和受最多|爽气看应少|晞发此窗前|鸡鸣海天晓
楼子燕脂色|灯前艳更鲜|看花直到晓|今夕不成眠
挥泪问新人|双蛾今几许|何事郎怜新|新人能越语
鸟鸣隔篱落|雨脚上翠微|闭门吟正苦|客来为解围
小白分无数|迎潮作队游|凭栏可垂钓|急为办纶钩
高树落凉阴|幽溪漾晴碧|山雨夜来多|苔痕上矶石
圆魄上寒空|皆言四海同|安知千里外|不有雨兼风
手足恩情重|埙篪欢乐长|要知能忘处|坟草两荒凉
野鸭滩头宿|朝朝被鹘梢|忽惊飞入水|留命到今朝
丝串镂文银|高城日照鳞|擐来曾搅阵|一镞不伤身
陶子沉酣汝|刘郎佩服之|元来天地内|乃有两东篱
天阔冰壶净|溪平玉鉴寒|卷帘看晚色|鸥鸟并阑干
斋馀睡兀兀|占尽檐前日|不与一瓯茶|眼前黑如漆
至今七星濑|多有子陵鱼|翁婿皆高逸|垂光后汉书
愿作随阳鸟|秋风一度翔|无恩承汉宠|祇忆见君王
真阳以解形|四大何足靳|指穷于为薪|火传不知尽
生憎子巂鸟|不解一催归|啼杀枫林里|连弓弹不飞
高斋何所有|琴书伴幽榻|中有吾伊声|声与猿声杂
春去无多日|勤来把酒卮|残花聊点缀|犹胜对空枝
一水横江练|千山彻夜辉|垂纶时自遣|应是旧鸱夷
且莫渡河去|风吹水倒流|隔沙人不唤|空老济川舟
口汲西江水|手弄东山月|一笑上扁舟|因之泛吴越
身闲无可奈|惟此度晨昏|与客正争局|闻谁休叩门
月出照松关|松阴正满地|恐有山僧归|终夜不须闭
崒堵藏真骨|东冈气象殊|烟云扫不尽|苔藓一痕无
生长桃花坞|不识桃花树|试问玄都人|已是春光暮
枇杷江外果|感念主恩深|长忆叨供奉|朝回满袖金
冷笑元无味|孤高别有心|谁将桃李眼|雪里解相寻
西风凉萧萧|雁过秋空高|时有岩桂发|落叶飞长皋
二五时难遇|沈沦下位多|乾潜与坤履|退谨养天和
层空蟠碧翠|佳丽伫雕鞍|夙聘黄金勒|风云冀北看
和凤东风转|携龙北斗回|人间遒铎振|天上兽樽开
道人心已静|得失久忘情|寄语枝头鹊|无劳送喜声
野亭傍幽溪|从此过溪去|平日已忘机|沙鸥何必惧
念子抱沈疾|霜露变滁城|独此高窗下|自然无世情
魏国乃为累|万古悲公子|世上无神仙|英雄如是死
院僻人行少|垂杨覆地丝|阁高秋色早|山远夕阳迟
山暝啼猿外|江平落雁中|几时将小艇|来问钓鱼翁
越山隔涛江|风起不可渡|时于图中看|居然在烟雾
空室寂无人|幽襟坐自整|吾心已不疑|何用论弓影
日出众山窅|月落众山黑|朝来捲幔看|气势凌秋色
白首看黄叶|徂颜复几何|空惭棠树下|不见政成歌
池面尖风起|烟痕一拂微|无形还有影|掠水去如飞
往来双涧路|脚下起尘埃|苕帚忙忙扫|何曾扫得来
痒处搔不及|赖有童子手|精微不可传|龉齿一转首
竹杖点湘斑|长随掌握间|老来方得力|伴我一生闲
月窟何人到|向来标榜新|如今折桂者|不止一坊人
远水接长堤|疏松绕斜谷|入寺不逢僧|一犬吠深竹
南山春雨晴|西溪春水满|孤舟钓夕阳|沙明绿蒲短
从士力难任|何其挂怀抱|不及在家贫|在家贫亦好
且买槎头鳊|去醉汉江酒|笑杀杜南征|沉碑管身后
黄蘖种作篱|围绕合欢树|不见合欢时|但见生离苦
三十六溪水|合为若耶流|曾经西子照|清似镜光浮
朱朱与白白|著意待春开|那知洞房里|已傍额黄来
四时运灰琯|一夕变冬春|送寒馀雪尽|迎岁早梅新
宝缕千祥集|灵符百疫奔|天人无限福|未老见曾孙
久不闻水歌|溪上夜如何|一声长复短|隐隐度烟波
石径生光怪|传流玛瑙坡|天人曾布地|此物至今多
大隗在何方|襄城亦奚有|莫言五尺童|曾稽轩辕首
玉颊酒潮红|醉头扶不举|杜老岂无诗|应为六丁取
人但千筒汲|谁知一线通|泉今人惜重|走卒与儿童
晓色春风里|维舟一小亭|看山浑不倦|待得雪峰青
大山插洪澜|定是关仝笔|缣素不能永|壁石写雄逸
晚照挂松萝|岩居乐事多|丛林归鸟集|远寺暮钟和
有酒斟酌之|欢然成諠哗|何必五侯鲭|李绿兮香瓜
客枕难成梦|秋宵转觉长|莎鸡鸣不住|阶下月如霜
结实黄金包|开花寒水玉|香色俱可怜|采涧勿盈掬
开窗临积雪|片玉坠遥天|鹤氅相辉映|人如姑射仙
南浦草仍碧|高楼日易斜|归帆傍水庙|箫鼓下神鸦
青郊迎淑气|华阙报芳辰|瑞木梢梢变|珍禽哢哢新
江雾秋楼白|灯花夜雨青|九天无一梦|此道付晨星
祠宇小窗西|松高柳尚低|垂垂青可爱|一带绕长堤
石罅来泉滴|松风杂涧声|天明有公事|还忆此时清
桐乳深藏鸟|苔花暗语虫|谁能借修竹|为我宿清风
极目生晚照|远树笼微阴|谁知清浅流|别有沧海深
上士思修身|下士思修名|身名俱不管|何事诵遗经
宜春连下苑|十里色葳蕤|白马翩翩去|金鞭半欲垂
啮冰激齿颊|咽雪涤胃肠|此水若寒月|饮之年命长
手把绿玉杖|脚踏青芒鞋|采药不觉暮|晚风山气佳
莫以今时宠|能忘旧日恩|看花满眼泪|不共楚王言
石梁无病涉|杖屦时相逢|昔闻横空霓|今见跨水龙
二程十四五|即为圣人徒|汝年已蹉跎|得无惊觉乎
缟衣携素月|香玉供采掇|可是姑射人|来散罗浮雪
一雨绿千里|楚山如近人|留君君掉首|何处秣陵春
悔寄孤山梅|悔折断桥柳|两地本无情|郎心那得久
切切松上风|齿齿泉下石|零露晓沾衣|童山夜升液
莺啭玉笙细|苔涵碧锦滋|杨花春欲暮|睡起和陶诗
孟月祠原庙|都人忆故宫|当年驾幸处|乔木鸟呼风
燕语今生事|花开夙世红|不知终日醉|何以谢春风
湛湛下修竹|味如饴蜜甘|人言此为瑞|无德可能堪
万叠峰峦秀|遥空散火云|兴来聊极目|伫立向斜曛
平江浮夜色|远雁带秋声|渺渺孤帆去|前山月正明
㶁㶁泉声远|流春到水涯|东风千万恨|片片逐飞花
石室寒飙惊|孙枝雅器裁|坐来山水操|玄断吊遗埃
何哉川上心|欲语还自默|安得玉溪翁|问我溪中月
沜东多杨柳|枝枝弄新碧|不系郎君车|常拂处十席
意其失兵久|怏怏必吾从|夺笏直前击|那知是孝童
石窟昔藏金|蟾光射百寻|今朝在何处|山景正阴阴
自得春风信|开怀待此花|馀寒固艰棘|今夕雪斜斜
春水流何远|春云暖故饶|柳边双燕子|时触最长条
经行古官道|何处有人家|时见荒山脚|一川荞麦花
色若栖文雉|圆如插绣幢|春葩应有并|秋卉合无双
岁晚湖山曲|风尘到玉林|定知梅处士|移貌不移心
几曾慕巢许|非是薄伊周|何忍的的去|先人有墓丘
瑟瑟西风起|松房夜掩关|月华凉似水|河汉在人间
秦川春婉晚|汉水路迢遥|不待凭危槛|离魂已暗销
此局终当有|宁期在此时|丹书何用见|名姓世原知
小舸系烟汀|谁知笛里情|寒芦风瑟瑟|正是晚潮生
双湖偃长虹|月出微澜静|鼓枻独沿洄|流光荡空影
莽莽乾坤雨|秋香岂未知|秋风将短鬓|千古一东篱
江南春草绿|江北未开花|佳人在何处|迁谪寄长沙
谁言今之人|不见古时月|古月照今人|千年同一辙
夹涧荣薝卜|倚竹颜如玉|溪鱼大上时|临流香可掬
叶舟维夏口|烟野独行时|不见头陀寺|空怀幼妇碑
念我浪游苦|分伊家食甘|才高雠忍杀|面冷子无男
春风马上梦|樽酒故人持|犹作狂时语|邻家乞侍儿
陶翁书甲子|楚客纪庚寅|村叟无台历|梅开认小春
秋树碧千寻|凉蝉叶叶吟|山中少同调|流韵入鸣琴
传闻三峡下|白雪捲青天|借得东邻水|潺湲亦可怜
趣收霜后实|供我洞庭春|未暇三百颗|作书怀故人
寄声淮水去|归思共滔滔|吾家何所认|门前双石桥
马上谁家子|停鞭唤索郎|当歌年十五|调笑酒垆旁
达磨非为后|瞿昙未是先|当来无量劫|懒翁得自然
餐霞吞沆瀣|一吸千顷湖|默坐更深省|心尘今有无
近徐山渐众|出济水才宽|始觉行无碍|兼知路不难
旭日照罗帏|美人初睡起|双鹊绕檐飞|良人隔千里
霜崖白石髓|火鼎黄金芽|生疏不入梦|饱饭煎江茶
春雨湿窗纱|辛夷弄影斜|曾窥江梦彩|笔笔忽生花
卤莽风尘者|相逢总问津|如何临别酒|重忆远游人
帘捲薰风动|庭空白日长|可怜双蛱蝶|犹恋菜花黄
狂夫渡河死|丽玉独伤情|翻入梨园谱|都成堕泪声
遥与齐侯会|江人故国存|夷吾嗟不见|北望是中原
斗鸡金作距|戏马玉为鞭|薄暮谁家宿|青楼大道边
黄芦满汀洲|白雁投江渚|何处远归人|征帆带飞雨
舣棹严滩下|相看两弟兄|溪风与山月|都是客中情
点点落林花|寥寥弄山鸟|何处一声钟|云峰万重晓
老子七十七|到处遮人壁|住世更十年|化身千百亿
狂胡初款塞|飞诏出云中|自古绥戎策|应难此日同
何人过三径|共此曲蘖春|月下倩人扶|花影铺满身
得意似鸳鸯|情乖若吴越|不向君边尽|更知何处歇
白露何苍苍|波光正渺茫|怀人成独坐|离思共流长
貌得乌衣族|春纤点艳妆|时随步摇影|行坐共韶光
山静夜如年|窗虚独未眠|一枝斜更好|月到曲阑边
日照不择地|雨润无遗草|吾心藏仁机|嫉恶亦能槁
郑声良可厌|闲抱七丝琴|欲识调弦意|理人先理心
食藕痊沈疴|制荷被吾体|未如对芳华|幽贞似君子
君能为置后|此意不可忘|峣峣峙头骨|正好玉其相
困来石上眠|梦绕泉石闲|山鬼按玉徽|山灵铿佩环
紫塞传龙拨|昆丘学凤鸣|春风吹白雪|总是断肠声
惜齿埋之土|何曾愿世知|终为交趾献|亦被普贤骑
琼南无酒家|酒向椰中取|椰子有一心|出酒如娘乳
醉折东篱朵|看如隔暮烟|莫惊颜色改|不是义熙年
殷勤语舟子|举棹莫匆匆|恐怕鸳鸯伴|飞息不得同
小妇晚妆残|洗黛重掠发|今朝画眉长|贪看初生月
十载元正酒|相欢意转深|自量麋鹿分|只合在山林
伐木结小亭|遂在此林下|倘有子献来|清阴堪共把
陶菊手自种|楚兰心有期|遥知渡江日|正是撷芳时
锦幛两边横|遮掩侍娘行|遣郎铺簟席|相并拜亲情
年长身多病|闲钞已试方|未甘先犬马|毕命报恩光
小妇不长妾|大妇不长妻|人生各有命|贵在与夫齐
青衫跨羸骖|白首供朝谒|自笑老忘还|不嫌官太拙
纤茎寒始密|秀叶晚逾滋|芳意君须识|群葩摇落时
有情痴故佳|无情黠亦尔|琅琊王伯舆|终当为情死
补之敕谥村|简斋致公辅|未必画惭诗|只为遇不遇
山下有酿泉|谁能似纪叟|但得此中趣|何须倾百斗
落日青山暮|疏烟古寺秋|望中无限景|都属钓鱼舟
呼吸湖中水|山椒寄此身|洞门风雨夜|电火逐霜鳞
闭门屏来辙|枕书睡初熟|觉来淡无悰|看遍阶南竹
反舌何时至|乘春入帝都|啼莺含愤恨|力小未能驱
采芝青溪滨|钓鱼青溪水|不慕磻溪名|莫洗颍川耳
麟晡麻姑擗|桃花缑母栽|天家青鸟使|飞去复飞来
花光何璀璨|八窗摇一色|春风过酒人|忻与花相值
夕籁鸣寒雨|晴峰出翠屏|风尘吾独愧|鸿鹄下苍冥
长城筑中宿|雉堞一万个|飞语岭外传|关中今已破
片帆天际阔|落日远山青|隐隐风前笛|行人不忍听
多罗四十年|偶未识摩毡|近有王宣政|时时与纸钱
所居无禹庙|有官升典签|掌亦我所欲|二者不可兼
面面隔深竹|茅斋在何处|遥闻犬吠声|试从此路去
山合松楸晚|沙寒橘柚秋|坐看鱼鸟近|历历镜中游
初生无毛者|伯乐号龙驹|七朝方始起|千匹也应无
涉水免褰裳|沿流不用航|何人探梅去|踏碎五更霜
甚处足横斜|孤山水一涯|从来个中水|只许照梅花
声出五音表|弹超十指中|鸟啼花落处|曲罢对春风
落日催归马|离心寄酒尊|一从分手后|风雨闭柴门
梅花如隐人|不与群芳竞|别坞春风多|寒流照清影
西来十万里|北渡一茎芦|刚道来传法|还曾传得无
春洲菰蒋绿|江水似空虚|望山以高咏|意钓不在鱼
熟睡一炊顷|清谈数刻间|未言能近道|要得暂身闲
弟也习音乐|一室自鸣球|五月候夷则|黄钟律应不
课仆𣃁桑窠|从头尽种花|莫教聂子见|怪我不栽禾
刷羽梁王池|春至欲言归|牵我东南恨|随君西北飞
出岫岂无心|层空昼结阴|油然空蔽日|底事不为霖
怀君属秋夜|散步咏凉天|山空松子落|幽人应未眠
清净方贻笑|庄严更舍身|基图虽肇始|识趣只庸人
石壁自磨砻|三叹用不久|如去到人间|为侬洗尘垢
松竹贯寒暑|而梅时往来|不知姤复意|随人谩徨徊
渡口和帆落|城边带角收|如何茂陵客|江上倚危楼
赤日涸大江|家家泣禾黍|如何千峰云|不作千峰雨
竹雨晓苍霁|松风阴碧圆|道人禅定处|神在蔚蓝天
烦恼浮生业|愚迷智自通|根尘如不染|识照曩缘空
水动花梢动|花摇水影摇|不知各无意|为复两相招
暮天俄惨淡|海作飏潮风|吹水来高树|疏疏雨点同
孤蓬知乍风|寒压澄江钓|不见石室人|万树传清啸
高鸟依依没|长河淼淼流|风尘随短鬓|去住任扁舟
此去非关兴|君行不当游|无因两处马|共饮一溪流
火烧土膏暖|阳气发畲田|尽斩阴阳木|斜禾种绝巅
云敛天长净|风恬水不惊|水天澄彻处|万里自分明
长风送棹歌|得鱼满笭箵|若逢朝市人|道是江南景
禅宫庭宇静|深翠万竿竹|忽悟瓦砾声|香严道机熟
名士每名泉|一瓢宁取贤|道行期及物|为涧定为川
桂江几千里|新水下浑浑|偶动乘流兴|堪浮五石樽
阳台花一片|落尽楚宫春|西家空作赋|原是梦中人
公为利名隐|我为利名来|羞见先生面|黄昏过钓台
渔艇已收纶|斜阳下烟水|寂寂掩篷窗|坐听舟人语
一线横大江|千螺簇层峦|空外飞鸟没|烟中片帆还
地仙不爱谷|种药方桥右|久雨不出门|猪苓大如手
好酒吃三盏|好花插一枝|思量今古事|安乐是便宜
水光浮柱础|天影带楼台|触石云孤起|吹潮雨四来
苍苍竹林暝|郁郁松气寒|纵横兴来笔|攲侧醉中冠
微月昏出东|美人秋卧起|明发送征夫|飞刍渡辽水
小小试部勒|诚可销长日|汀沙点鸦鹭|局带山云湿
朝旭动前池|风漪隔窗过|纷披觉鱼乱|散漫知萍破
云落清河夜|天横片月凉|江楼莫吹笛|明日更山阳
闭门三日雨|断送春归去|西郭少人行|草深迷渡处
壶矢新油幕|春芜旧战场|候亭闲夜柝|归袖著天香
古来韦与杜|阀阅冠当年|今日城南问|惟馀尺五天
世路机兼阱|人情楯与矛|客能知许事|兀兀一时休
西山送夕阳|东山迎素月|一百八声钟|迎送何时歇
石畔竹扶疏|棠梨结子初|坐来山雨过|湿翠欲沾裾
云巢八十翁|观化得三昧|无声凉月下|适意芳草外
忍草迷香径|空馀屋数间|香炉烟不起|苔蚀鹧鸪班
中天白玉台|高挂九千尺|薄暮海东云|先送嫦娥入
绿阴初散地|今有入檐枝|开窗对潇洒|岁寒惟独知
绝漠功虽大|长城怨亦深|但知伤地脉|不悟失人心
孤舟漾暧景|独鹤下秋空|安流日正昼|净绿天无风
乾坤皆数五|日月正符同|但仰重离照|难名厚载功
南山与秋色|气势两争峙|闲者解其纷|君今巳闲未
白露横江面|凉飙起林樾|孤唱无与酬|垂纶钓明月
𫍢𫍢夸毗子|东家复西家|寻常家计事|岂足向人夸
黄区将欲尽|黑白以全无|上下齿更展|十二岁应馀
坐阅数朝主|竟为何代人|汉官扬历遍|更作虏师臣
殷勤魏公子|落莫吴王孙|下客独垂泪|伤心思旧恩
有德天同寿|无为日更长|每逢端午节|双上万年觞
一辞金銮殿|甘作醉乡侯|东华尘似海|不及卧糟丘
黄陈今不作|天地少诗人|不是诗人少|诗人未必真
画里瞻尼父|庭前即杏坛|春风吹绿树|真作泗滨看
贼来那可迩|而敢以身迎|身岂不知爱|心乎恐母惊
秋草深数尺|我栖在其间|英英鸿鹄志|乃与雉兔班
双扉起岩石|尘客过应稀|千古掩不得|从教云夜归
看石忽有诗|攀蕉书其上|夜来雨打叶|惊闻金石响
草长连朝雨|花残一夜风|青春留不住|啼杀白头翁
片纸来天外|封题自广州|开函不敢读|一字一生愁
小醉清晖阁|横江更一杯|远山寒日晚|诗老忽然来
抱瓮行灌蔬|桔槔宁复用|园葵一饱馀|栩栩南窗梦
君莫谈知己|我厌闻此言|最薄大梁客|欲报信陵恩
小儿是岁星|朝游王母家|海山桃实成|献寿来烟霞
把盏非怜酒|持竿不为鱼|唯应嵇叔夜|似我性慵疏
努力张谋父|躬耕老白云|无年俭足用|此外奈何君
天下已归周|一竿果何钓|挟车向君门|莫待飞熊兆
妆成泣秋风|含情泪如雨|不信妖艳姿|空房翻独处
才送夕阳流|隔花新月上|疑见垂钩人|触波生碧浪
此际山阴道|啼惟有莫鸦|万山无寸碧|何处认梅花
浮云吐明月|流影玉阶阴|千里虽共照|安知夜夜心
幽树高高影|山花寂寂香|山天遥历历|山水急汤汤
春苑月裴回|竹堂侵夜开|惊鸟排林度|风花隔水来
暂与云林别|忽陪鸳鹭翔|看山不得去|知尔独相望
三年此村落|春色入心悲|料得一孀妇|经时独泪垂
申椒芳声远|秉德类幽人|时来荐瑶席|慎勿佞夫君
惟友于兄弟|惟顺于父母|无忝尔所生|造端乎夫妇
偶然眠一觉|推枕起来惊|寂寞犹前日|荣华已隔生
一斥投边裔|寒肌瘦似梅|下帘秋院里|犹想共抡魁
坐筹纡庙略|立道是边机|但拜封侯印|何曾着铁衣
驾鹤归三岛|骑麟入九霄|祗应明月夜|来此坐吹箫
东海有一鱼|无头亦无尾|更除脊梁骨|便是这个谜
雪积千山素|行歌履迹穿|腰间有樵斧|猛虎莫当前
玉面婵娟小|檀心馥郁多|盈盈仙骨在|端欲去凌波
香篆添新火|丹炉养旧灰|碧窗如水净|坐看绿阴回
忽见不是画|近听疑有声|落落不对俗|涓涓长自清
钟鼎山林事|都卢一梦中|观音门里去|叶叶响悲风
岸柳绿丝丝|春风不断吹|昨来谁此别|留得折残枝
万里塞边城|年年拥重兵|秋风鸣铁骑|落日照旄旌
寒食添坟土|重阳几度秋|北邙山上月|尽照古今愁
昨夜西斋雨|秋声叶叶凉|平明推户看|苍雪洒衣裳
怪藤摇苍烟|芳林滴晴雨|闲花逞娇姿|笑舞春风里
石阑护苔枝|相对黄昏月|问答本无言|翠禽强饶舌
评事不读律|博士不寻章|糊心宣抚使|眯目圣神皇
隐君在何许|遗迹此山阿|春风闭门处|回首空烟萝
山寺净松筠|藤萝蔓径路|云深僧始归|长啸空林暮
鸟语斜阳外|山花夹涧红|古墙唯一堵|云是越王宫
连环结连带|赠君情不忘|暂别莫言易|一夕九回肠
地僻无人扫|亭前长绿苔|不知丁氏鹤|何日可归来
万仞冰峭折|寒声投白云|光摇山月堕|我向石床闻
长林上晚烟|明月曜深夜|重闭岂吾心|自回俗士驾
首出群山内|晴窗几处看|不因风雨折|开槛满溪寒
汉用亡臣策|登坛授钺时|须知数仞土|曾立太平基
壮发飒衰素|故山郁嵯峨|乡书千里发|客泪一时多
庆娘颦翠眉|春瘦怯罗衣|笑问采花蝶|如何成对飞
鸣桡过瑞洪|微月下西岛|别有泛湖歌|歌声良自好
千花争笑日|百卉斗鸣禽|阳春真可贺|莫惜千黄金
封疆七百里|禄秩二千石|拥节祠太山|寒天霜草白
砥柱中流起|千秋障颓波|我欲据其巅|浣手探银河
山月吟声苦|春风引思长|无由及尘土|犹带杏花香
闹处光阴短|澹中滋味长|畦蔬寒可掬|清白带凝霜
清阴满我庭|苍苍六槐老|野性苦避人|青苔不须扫
北斗寅初建|东郊气乍迎|土牛敦岁事|彩燕动春情
盛德天垂覆|皇明日照临|九重颁汉诏|四海识尧心
太白三千丈|庐峰上与争|道人闲管事|终日作山评
花落叹丛孤|随风莫漫徂|不念枝独处|当念子谁俱
数捺皮应缓|频磨快转多|渠今拔出后|空鞘欲如何
汉文方有道|痛哭岂狂迷|世事宜先虑|无令后噬脐
君行过吾里|舣舟并南山|王郎两徐子|非必素往还
苍筠倚乔木|古色秋逾好|谁能著茅亭|相伴此君老
客里又深秋|凄凉怕举头|西风吹败叶|叶叶是归愁
平生才不足|立身信有馀|自叹无大故|君子莫相疏
仲任书卷尽|平君不数充|相逢何以慰|细酌对春风
有客学无心|庵云结宝阴|松风深夜起|时作老龙吟
英英露下兰|香与凡薰别|埋没萧艾中|佩冷无人结
祗应曾布地|往往化为鱼|一遇丁千骑|禅人便结庐
玉屑装龙脑|云衣覆麝■|何堪夜来雪|香色两凄迷
今朝江水浊|云日汩虚明|我欲澄流滓|中流见太清
四体不可风|多汗常如沐|却妒西园里|凉飙振佳木
偶尔被秦官|何荣亦何辱|万古徂徕云|依然卫其足
鸣蜩暗递秋|碧色盈高树|西风且莫吹|吾欲湖西去
晓行不知程|梦醒闻细浪|曙月逐鸡声|棹歌来枕上
出门无寸瞩|凝望立溪湾|修眉在天际|料得是秦山
细雨寒江路|疏灯独夜舟|故山今寂寞|为访玉峰秋
独占溪山胜|寒香问有无|但持风格在|不受俗尘污
种岂依云碧|栽非傍日红|吴刚休错认|生意任秋风
见便道下见|碧眼明寸电|瞥尔落思惟|何啻千山远
径李浑秾白|山桃半淡红|杏花红又白|非淡亦非秾
江水挼蓝绿|江花泼火红|夕阳幽鸟下|浑似画屏中
憔悴两娥颦|春山锁恨深|东邻正尝胆|西子谩扪心
倭麻来海外|裁扇剧清真|还凭玉堂笔|写寄玉堂人
秦蜀云千里|分携十载馀|朝来逢驿使|才接一封书
白露沾人袂|秋风落日斜|忧来谁共语|烂醉是生涯
袅袅古堤边|青青一树烟|若为丝不断|留取系郎船
春深草木长|地幽苔路滑|中有玄真翁|披衣卧萝月
木末芙蓉出|花岩草树齐|陵高诸象北|江白数峰西
旭日耀苍𪩘|翠岚生嫩寒|幽人诗梦醒|清响得松湍
世网角雄雌|官途争是非|人方酣蚁战|吾自送鸿飞
释子望山归|樵夫下山去|遥望紫翠间|斜阳映枫树
儿女需京缬|经时买未归|似嫌无艾虎|不肯换生衣
闻道阳都女|连娟耳细长|自非黄犊客|不得到云房
草阁临春浦|蓬扉惊曙鸦|水明残夜月|云傍隔溪花
迢递长征路|徬徨欲曙天|最怜清素影|扑落马蹄前
种花真濩落|曾不救号寒|我自金芍药|从渠黑牡丹
何苦毫厘较|当思手足亲|丁鸿与刘恺|让国是何人
此地是东皋|人烟馀废井|可怜蔬叶湖|尚有楼台影
清风贮深洞|四时长氤氲|飘然无遽发|散我山中云
身世本如寄|去留俱洒然|秋风南北路|相别寺门前
疏声连永夜|寒意薄吟身|惆怅三生梦|彭城古木春
布褐聊自温|豆粥长一饱|只此深山居|逍遥以终老
献纳青云际|狂言非至公|何由返初服|美酒沽新丰
金粟花开日|天香散玉墀|嫦娥解人意|折赠最高枝
有客时扣门|云是商山侣|石鼎旋烹茶|对之共玄语
偶然风折木|村犬吠成群|此事真难免|问君闻不闻
西风奋枯林|潮沸盛湖晚|泪眼对残阳|看君行渐远
万事皆零落|平生不可思|惟馀酒中趣|不减少年时
门系青骢马|多应问病人|小官好疏散|莫讶懒衣巾
客泪如危叶|长悬零落心|况是悲秋日|临风制不禁
松叶堪为酒|春来酿几多|不辞山路远|踏雪也相过
高树满秋风|茅檐正倚东|相知穷白首|不厌说山中
卜居何所尚|静轩栽此君|万事付流水|一心游白云
有酒聊排闷|无书可订顽|君看鸾铩羽|不若早知还
忧居五十载|陆子最堪悲|恽独非人子|而云有既时
山色斜依寺|江流曲抱村|时有山僧出|残阳独掩门
天寒稻粱少|万里孤难进|不惜充君庖|为带边城信
茅焦甘伏质|考叔请留羹|大隧如初乐|咸阳虚左迎
水犀莫射潮|祖龙莫驱石|海水尚可填|人心填不得
锅里爷娘语|寒山太猛生|不妨时着眼|直是得人惊
青青西子湖|花芳媚鸳渚|十里锦舟莲|琵琶拂江水
午风吹芒鞋|独往忘日夕|指点山阿人|衡门在萝薜
遥望城南道|青青草色新|春风生锦棹|时送楚江人
水国南连楚|沙场北近胡|春风万里别|明月两乡孤
歌罢齐纨扇|沈吟异代名|自怜长信帚|不是主恩轻
久养笼中鹤|如何却放归|不知初放日|曾别主人非
朝日丽郊原|晴风动梧竹|沙鸥不避人|飞来傍船浴
楼下水连天|楼居即水仙|何须把黄卷|极目尽红莲
故人能写竹|标格似湖州|静对西窗下|清风满纸秋
可怜南粤王|箕踞而椎髻|时时问陆生|吾何如皇帝
我适抑不已|汝须不当急|机竖尚亏投|影没大难及
夜静露凝白|月朗星更稀|满庭湿空翠|浑欲侵人衣
有客问烟萝|山家在何处|笑指碧溪头|遥遥踏花去
客醉眠未起|主人呼解酲|已言鸡黍熟|复道瓮头清
山晓冷恓恓|开门雪覆溪|偶随麋鹿迹|不觉过桥西
金谷觞豪友|珠楼拥艳姬|南交来处悖|东市悔何追
众流俱到海|万籁各还虚|寂寞空山里|高斋独掩书
被雪一枝好|令人双眼明|未须贪结子|对汝不胜清
外瘴须磨点|黄连最能驱|乌鱼骨颇妙|辄莫用珍珠
渌水明秋月|南湖采白苹|荷花娇欲语|愁杀荡舟人
归向铜官下|长歌采蕨薇|岚光霏翠雨|湿尽薜萝衣
山酝今朝熟|溪氛起正炎|醉予难酩酊|泣汝泪阑干
游子归心切|提壶看落红|告天天不语|愁杀白头翁
渺渺涵秋色|澄澄生晓烟|四山潦初歇|寒玉一溪完
二月芳堤媚|轻风漾碧丝|行人莫系马|恐有断肠诗
野云闲带雨|林木静无风|村落一溪外|民田四望中
拟处秋毫准|弯时二石强|木心元正直|持汝献文皇
粉落空床弃|尘生故箧留|先来无一半|情断不胜愁
石如狮子吼|山作石头城|剩有莲花座|云深可结盟
曲径接山阿|行人说救婆|须知闺室女|识见已争多
萌牙资暖律|养育本仁心|顾彼苍生意|安知帝力深
阿郎久不归|春夜旷兰室|月在荼蘼西|含情理瑶瑟
江南孟冬天|荻穗软如绵|绿绢芭蕉裂|黄金橘柚悬
残照下西岭|微云翳轻阴|蹇驴行落叶|归思在秋林
骏马红丝络|幞头金蟒装|儿童拦路语|道是赛牛王
闭户长听雨|看花不当春|可怜三二月|又别几多人
宝历垂无极|璿玑转未央|绣楹膏露润|玉殿紫芝香
斗帐春风冷|薰炉夜有香|薰炉长不转|香气自飘扬
騕袅锦障泥|楼头日又西|留欢住不住|素齿白铜鞮
青女随明月|来时夜已深|霜花结不就|散作海天阴
小舫行乘月|高斋卧看山|退公聊自足|争敢望长闲
春风自东来|为我掩竹扉|草堂坐终日|花影摇人衣
群虎人所畏|人怒群虎戮|试看堂室间|坐卧斓斑褥
母家令足食|父族使安生|睦党可谓孝|能之惟晏婴
云坞蕴招提|开窗面湖渚|时发钟磬音|惊散沙鸥侣
越辣调扶霤|吴酸沦露葵|清斋慈母喜|莫使玉盘迟
海内中和日|云间上巳辰|笙歌九天半|花木十洲春
晓天青脉脉|玉面立疏篱|山中尔许树|独自费人诗
忽弃国中去|疑为方外游|早知守都厕|何似莫仙休
青青水中蒲|长在水中居|寄语浮萍草|相随我不如
君为乡校长|我政旅人居|借屋元相近|相过莫放疏
间或僧人到|闲常羽客过|启玄疑恍惚|谈妙欲云何
已见花开盈|复闻鸟语浅|谁能并云轩|醉月辞轩冕
绛帐风流远|青襟礼貌骄|定须防射羿|何必问嘲韶
世才无八斗|君橐少千金|欲审低昂处|空伤去住心
双翼锦䙰褷|花间任尔栖|春来自多雨|日暮不烦啼
藤古结为梁|蜒蜿凭云雾|步之时动摇|疑驾彩虹度
多谢水精盐|能使羊欢喜|羊也亦多情|以妾颜色美
利与善之间|微似未易断|欲无毫厘差|要在明厥辨
采莲复采莲|水深清见藕|欲折红芳枝|绿刺伤侬手
驱马岘山南|磴滑不能上|惆怅石城人|秋风摇两桨
枫叶藏蛋雨|春江作画图|谷回诸径浅|天远数峰孤
自笑心何劣|区区辨所冤|伯仁虽到死|终不向人言
坐见三生事|宗传一衲来|已知无法说|心向定中灰
津陆元殊种|名称偶尔同|秋光波底见|堤上忆苏公
不置一杯酒|惟煎两碗茶|须知高意别|用此对梅花
了了还未了|都忘了始真|登堂知此意|方悟死前身
巨尾蟠深草|丰毛覆古苔|雕栏临绮席|长欲上香台
强欲登高去|无人送酒来|遥怜故园菊|应傍战场开
志士不贪生|贞夫耻幸成|如何鲁连箭|只解射聊城
参差荆中门|出没沙际语|落日衔半规|秋天避禾黍
葺垒去来忙|喽喽语夕阳|茅檐最安稳|莫恋杏为梁
佞舌儿女柔|异教蜩螗喧|岂能听蛙黾|静枕诗书眠
雷雨惊春候|寒梅次第开|金陵有逸客|特地看花来
日暮庭阴合|斜阳复照檐|不禁风絮乱|寂寞掩重帘
叠叠波纹绿|摇摇雨气香|菱歌谁与发|秋兴似江乡
斋居玉几侧|秋草下帷青|弟子谁都讲|来传董氏经
不无银泥带|非少玉搔头|春光不爱妾|归去思寒秋
棹发千花动|风传一水香|傍人持并蒂|含笑打鸳鸯
庭院春日迟|风回翠鸾舞|谁倚玉阑干|摇动燕脂雨
酒入春逾劲|天寒烛始明|偶然倾一盏|政尔忽三更
目断归帆急|无身可得追|亲庭如有问|依说鬓成丝
闲寻十九路|坐断千万心|运甓何为者|当知惜寸阴
根节含露辛|苕颖扶楥绿|蛮中灵草多|夏永清阴足
推窗送远目|依依烟树开|白云拖片影|飞过北村来
石磴不可攀|前头有积雪|安得冰玉人|对此清高节
圣水出温泉|新阳万里传|常居安乐国|多报未来缘
借书人取亟|贳酒仆来迟|世事都如此|那教放两眉
不识弁山面|相逢笠泽诗|祇应晚云散|玉立对门时
残暑犹拖尾|新凉恰打头|酒方屯鲁郡|舞已彻伊州
一枝青竹榜|泛泛绿萍里|不见钓鱼人|渐入秋塘水
秋树鸟声寂|夕阳山影沈|遥怜抱琴者|不为访知音
四脚难移动|一边汗出微|口中时吐沫|见此莫生疑
三世如旦暮|四大转风火|傥能了无生|如观掌中果
种花莫种奇|卜筑何妨拙|客来归不归|楼上看明月
故乡宛如昨|近郭多池台|一别同心侣|无因数往来
渭阳曾读未|对酒偶言诗|舅作如此语|儿那能不悲
诗人头未白|又欲隐羌山|好把无声意|光传满世间
朱阑转午阴|银屏倚春倦|梦作花间蝶|飞入昭阳殿
未学回风舞|初成拜月妆|故令青女妒|一夕月阶霜
心知花在树|望月影微微|不到寒香入|终然此意违
画棁文垂藻|蠲灾意已传|哲人思厌胜|东井刻荷莲
藏叶身同柳|临风口学簧|间关求友意|珍重托东后
勤披莱子服|种汝奉高堂|汝自忘忧尔|吾忧未易忘
夜阑窗户闭|黄庭看未终|西岩一声虎|四壁生清风
清紧如敲玉|深圆似转簧|一声肠一断|能有几多肠
短篷收辑濯|栏楯占濠梁|受得两三客|更添垂钓郎
巧笑解迎人|晴雪香堪惜|随风蝶影翻|误点朝衣赤
秋来烟水多|芦苇渺难即|爱此江上花|日坐双㶉𫛶
谓橘不盈握|胜橙颛进皮|香齑难共捣|遮莫蟹螯持
不见东林寺|但闻隔水钟|溪深桥复断|片月挂孤峰
雨在时时黑|春归处处青|山回失小寺|湖尽得孤亭
胜形开太古|灵养得魁岩|自是两仪里|风长日月函
㶉𫛶借毛衣|喧呼鹰隼稀|云披菱藻地|任汝作群飞
僧亦知农事|岩耕近瀑泉|筑堤分涧道|引水灌山田
妖姬年二八|艳色妒名花|莫问张君瑞|崔莺是婿家
春暖未苦热|秋凉未甚寒|小车随意出|所到即成欢
旭日照金阊|九衢散晴绮|绣縠雕盘餐|佻佻贾人子
杪忽腰如壶|联绵窠若屋|毋轻怀袖间|防此虿尾毒
执斧一长揖|白门雨雪深|十年曾有约|珍重昔时心
小山有桂枝|名自骚人传|我欲辨其族|衰病空慨然
忆渡桃叶时|绿杨娇粉面|丈水五石泥|好影照不见
苔护石桥古|潮灌芝兰薄|中有一庵闲|莫是文潞国
丹霞覆苑洲|公子夜来游|终宴清露冷|折花登彩舟
遍索天地间|彼此最痴癖|主人幸未来|与君为莫逆
琴挑何曾动|梭投未免惭|女郎循古礼|元不解清谈
曾到西湖上|闻香不见梅|推窗窥月色|竹外一枝开
著论必无同|乾坤孰此容|人扶周孔教|用世且无功
花开方命酒|月落复闻箫|夙昔烟霞约|垂杨荫板桥
庭下晓来霜|菰顿芭蕉折|络石瘦菖蒲|独抱青青节
湿翠映繁红|东园起暖风|春光何处是|都在鸟声中
人道日在天|我道日在心|不省鸡鸣时|泠然钟磬音
真人昔住世|所至树以松|当知千岁下|遗子以清风
少妇试春衣|当垆出素手|五陵游侠儿|下马一呼酒
所忧目力尽|未问两足酸|云峰三十六|一一皆可观
有山名石鼓|千古镇南溟|大手不劳力|动时天下惊
日高啼鸟散|江转断云遮|向客说残梦|昨宵曾到家
白云出山去|摇曳或西东|人住白云下|安然心已空
出谷传声美|迁乔立志高|故教桃竹映|不使近蓬蒿
露涤清音远|风吹数叶齐|声声似相接|各在一枝栖
人从生处乐|鸟过故乡悲|英雄汉天子|一歌双泪垂
绕舍种修竹|清风长满筵|天姿本来净|不雨亦娟娟
我得圣俞诗|于家果何如|留为子孙宝|胜有千年珠
莫嗟骐骥老|不识云台仗|此骥天所月|未易论得丧
我抱栖云志|君怀济世才|常吟反招隐|那得入山来
櫩蛛巧经网|林鸠拙营巢|孰知拙反胜|网坏巢独牢
衡门俯寒江|隐隐修竹下|鼓棹问奇人|扁舟快于马
阖辟如变化|用舍如随时|把柄一入手|炎凉夺天机
下阶见明月|起舞一裴回|呼儿扫花影|月落始能开
小小一军持|时露春消息|掷去色即空|插来空即色
片霞照仙井|泉底桃花红|那知幽石下|不与武陵通
未能无所寄|养鹤复栽梅|鹤亦太多事|高飞候客来
人间睡正浓|月到修髯底|三伏凛如秋|蒙头思衲被
冷语可销暑|昔人曾咏之|我来登雪观|政值绿阴时
吟坐久忘眠|银灯花灿然|明朝风雨霁|行李早言还
稍过花砖界|愁侵妙月痕|呼僮将我斧|吾意在除繁
忆昔趋阊阖|朝鸡促晓声|何关蝇辈事|也复强飞鸣
日月湖中久|时闻冀北音|鸿飞如我待|鼓翼向山阴
颜色耐雪霜|桃李不能妒|但取节操高|莫起夺朱恶
洞外野泉鸣|终古无人到|五色吐仙云|四面围丹灶
台外绕佳山|台中垂暇日|龊龊绛守居|徒劳夸绍述
博学非能事|详言道转乖|只因省气力|处处是吾斋
川馆亲蚕后|宫房献茧初|香缯争点画|彩缕竞垂舒
墙头桑椹落|树上春鸠鸣|独立衡门晚|满川云气生
蒲萄更马乳|岂及安石榴|凿空西使返|正是汉家秋
家有寒山诗|胜汝看经卷|书放屏风上|时时看一遍
问花开何迟|问花底急飞|人闲惜花少|阆苑等花归
为客厌城市|还家辞世纷|朝昏何所见|但有四山云
在山水非清|出山水非浊|泉源但无壅|沧海端可学
怀人得清晤|此乐浩无期|剡溪兴尽返|未喻伐木诗
金华山下路|吾亦爱吾庐|终岁无车辙|阶前草不锄
诗与风骚迫|文兼史汉长|半山非不尔|僻学汴梁亡
金雀玉搔头|生来唤莫愁|自从欢去后|不出石城游
高阁月初朗|他乡酒易酣|今宵同作客|不记是江南
玄冥严号令|四野雪花飞|莫道深宫冷|贫民未授衣
开门无一事|终日饱看山|石罅鸣流水|翻惊响佩环
皇皇问津者|藐藐耦耕人|不识吾夫子|宁非古逸民
高坡势建瓴|触石惊涛沸|入耳转声清|庐峡参差是
冉冉浮素空|悠悠隔秋树|幽禽何处来|冲破匆飞去
雨来元有路|风过本无痕|小立清溪曲|攲眠白石根
去去别淮浦|行行到江乡|渐觉故人少|空愁前路长
策驴风雪中|东君献诗料|花惊非故吾|聊复索花笑
垂柳万条丝|春来织别离|行人攀折处|闺妾断肠时
心如红豆蔻|两瓣苦相连|愿得重欢好|同衾及富年
孤帆落日明|青山相映带|遥遥万里情|更落青山外
散诞春耕馀|牧儿亦有乐|常以蓑笠随|为防风雨作
倦枕回尤数|东方不肯明|只将无睡耳|终夜著蛩声
欲折枝高出|烟凝望欲空|光生三径月|香作一林风
日落烟水寒|解缆清江渚|中夜北风来|相送潭州去
诏下龙荒去|阴山雪作花|君恩深似海|临发赐琵琶
双剑黄金饰|曾随我马征|匣中连夜吼|可是海波惊
草生磐石上|根深石不露|水流磐石间|风吹下山去
仆奴凌主人|夷狄犯中国|自古知不平|无由能绝得
入山何所见|云树春濛濛|安知巢居子|避世于其中
穷谷寓形久|惭无问俗方|文章古刺史|今昔窃馀光
千句竟成闲|片言如泰山|欲知语与默|意在合离间
青史高遗迹|黄垆掩旧封|宁知陌上兽|何羡水中龙
山僧不厌野|才子会须狂|何处销君兴|春风摆绿杨
不识严僮仆|能无畏影衾|心开双目朗|匝地鬼神森
霹雳沟西路|柴荆四五家|忆曾骑款段|随意入桃花
静看秋江水|风微浪渐平|人间驰竞处|尘土自波成
唐室恢新造|秦王有大功|一人居北极|太子在东宫
人生岂无别|咫尺异言笑|况复万里遥|风烟接蛮徼
只言梅信末|不柰此愁何|莫待一枝折|撩人愁更多
野鸟云山去|庭阴有坠毛|东风吹尽力|欲起不能高
露冷银床湿|秋高玉宇清|天风助清思|吹送九皋声
掩却船上窗|莫使入月光|月入风亦入|我无破衣裳
雪艳燕脂萼|京都核远来|游人初识面|不作李花猜
汉家轻壮士|无状杀彭王|一遇风尘起|令谁守四方
葵荒还自理|酒熟不用沽|因窥瓮中牖|悟得先天图
玉笋凌空出|参差翠霭多|还承天上露|入夜浣星河
何年开一窍|神斧凿玲珑|登天从此路|人在绿云中
清绝畏人知|幽香发深省|故用此时来|徘徊花下影
安得知音人|来辨肉和丝|花间与月下|冷然独奏时
石屏秋雨净|野树晚风微|忽忆前溪好|应须踏月归
楚水苦萦回|征帆落又开|可缘非直路|却有好风来
未别何人惜|别去令人忆|古来离别间|有泪多横臆
早蛩啼复歇|残灯灭又明|隔窗知夜雨|芭蕉先有声
朝阳动湖水|春色入名园|邑人千万户|日日望朱幡
娇态能倾国|蛾眉解杀人|妾身亦何幸|为国净边尘
永日兴难忘|掇芳春陂曲|新晴花枝下|爱此苔水绿
枯荻饶霜风|暮寒声索索|无限有微禽|捉之宿如客
风雨何年别|留真向此邦|至今遗恨在|巧过不成双
公在忠州日|人高长者风|忮心无后段|宁愧赞皇公
华堂闻鸟语|隔林送鸡声|悟证无生理|空门掉臂行
暖律催花蘤|晴晖活柳枝|发生虽有信|造化本无私
还家傥无事|莫负故园春|衣锦儿嬉尔|从来笑买臣
愁心贮折麻|佳期怨采绿|思君肠九回|何似黄河曲
春雨津浃洽|秋苗香苾芬|京坻看便是|完固促修囷
燕丹谋国事|田樊空自戕|卿匕一何短|王剑一何长
风月本无穷|台观亦□恶|妙处吾能言|却恐儿辈觉
开轩道山下|时登道山上|美人今在否|日暮增惆怅
疏此竹下渠|漱彼涧中石|暮馆绕寒声|秋空动澄碧
捲帘清梦后|静角掩山城|气射灯花落|饥肤片玉明
红豆生南国|春来发几枝|愿君多采撷|此物最相思
已漏风声罢|绳持也不禁|一从经落后|无复有贞心
清宵游桂馆|灯影散红云|手拂芙蓉露|香沾翡翠裙
甲马幽州路|英雄不自量|凯歌迎劳处|方识小秦王
铸石那能似|玻瓈出自然|光含秋水影|尺寸亦空天
我上和光洞|榴花开五色|不见皇祐人|踟蹰空太息
路涌金沙地|高人此筑庵|为询林下客|妙语与谁参
青山寂无言|白云自舒卷|对此淡忘归|何心在轩冕
手弄朱丝弦|音从太古传|山中无和者|幽涧落寒泉
离心似明月|皎皎在方寸|但令光不遗|道远何足恨
闲过天孙宅|烟花幽赏多|双塘芳接树|曲涧远通河
当时计水功|直为万世利|梅梁破浪归|底事成儿戏
人间三伏暑|海内一薰风|独咏微凉句|公权似不公
长信翠娥老|无人慰所思|更怜光月夜|是妾断肠时
夜宿大港口|月林闻露蝉|稳抛船尾缆|莫近浅沙边
夷门秋水亭|梁王古台下|台前旧堤路|尽日无车马
参差佛头山|迤逦鲛人室|但许日高眠|何妨气萧瑟
怀哉此佳人|春颜美如玉|清夜月明时|弄珠江水曲
贫因几首诗|闲高一著棋|瓜田常嘿坐|不愿有人知
病来贪睡早|推月出山前|月色不相舍|小窗还自妍
沧浪临古道|道上石成尘|自有沧浪峡|谁为无事人
妻子休相咎|劳生险自多|商人岂有罪|同我在风波
怀情既不尽|谥隐亦何疑|截舌帝其怒|在天灵可欺
丘中酥醪香|叠曲松花旁|隐矣桐柏水|剪圭封醉乡
发狂形骸忘|长啸天地杳|白眼向世人|知心良独少
朝衔新藻游|暮托淤菹息|幸无涸辙忧|不望监河泽
滩行逆上船|杨柳画桥边|正恐风湍急|劳将百丈牵
相劝醉年华|莫醒春日斜|春风宛陵道|万里晋阳花
新穿崖下井|微霞映深静|松风时来拂|娜娜匡岳影
危楼插湖脚|绀碧十三间|待月客无寐|看山僧自闲
惆怅昨宵梦|千思与万思|黄河流入海|岂有上天时
索句亦无心|拈花成口号|山雨没荷池|何处朱华冒
闻道南湖曲|芙蓉似锦张|如何一夜雨|空见水茫茫
凿井交棕叶|开渠断竹根|扁舟轻袅缆|小径曲通村
宝叔存遗塔|影摇湖水光|层层仙露湿|苔藓自生香
夜夜梦莲宫|无由见远公|朝来出门望|知在雪山中
泠泠清溪水|倒流向幽谷|任洗高人耳|不濯凡流足
采芝暮言归|紫云生谷口|山空明月秋|倚石不知久
鹧鸪不入馔|松柏有常心|归来应未老|但道古犹今
出岩初袅袅|映日乍晖晖|倏若阳台女|随风化雨飞
海气层云尽|山烟远烧浮|孤臣随早晚|一饭是恩州
绿野池新凿|平泉墅又开|乃知造凉殿|谏者不能回
不信长相忆|抬头问取天|风吹荷叶动|无夜不摇莲
三峰峭而尊|凝神入虚靓|青天动光彩|灭尽浮云影
深涧迷芳草|晴云鼓枻来|王孙何地隐|空有读书台
爵禄不入心|牛肥了耕稼|绿阴生晚烟|归来两闲暇
削成一峰尊|嵚崟势无敌|千秋大吕亭|青入岱宗色
因风消蜡炬|无影落澄湖|寒热一时尽|清辉何处殊
处膏非自润|在寸敢矜长|试用蔀家暗|回为邻壁光
日日行青山|无竹不可留|可怜春风中|桃李多春愁
凉飙袭庭越|如闻金石响|知君有新句|题在木叶上
漠漠秋清月|萧萧野岸风|寒芦休拣尽|全树上林东
障拥芙蓉竞|灯随榉柳移|繁星临迥野|疏雨过高池
潇湘明月夜|眼底见苍云|众木皆零落|空山秪此君
临水复攲石|陶然同醉醒|山霞坐未敛|池月来亭亭
世俗传偷药|嫦娥以此名|唐人皆咏月|吾取玉川生
风俗无难易|治之端在人|古夔尤易治|风俗本来淳
牵驴饮江水|鼻吹波浪起|岸上蹄踏蹄|水中嘴对嘴
江花随意碧|照水可怜生|不见采莲女|映妆羞月明
沤生复沤灭|二法本来齐|要识真归处|赵州东院西
问酒竹篱深|寻诗土花碧|石上更盘桓|长啸情何极
祖母恩深厚|陈情乞养终|祇闻儿养母|孙亦与儿同
楼船济汾河|中流渺云雾|耐可鲜荔枝|不到桑乾渡
曳杖行何适|桃花一坞红|回塘积落英|从君识东风
青青水中蒲|下有一双鱼|君今上陇去|我在与谁居
后皇有嘉树|剡棘森自防|安得上摘实|贡之白玉堂
不见浣纱人|空留浣纱石|石边春草痕|想见罗裙色
不随丹诏起|苦被白云留|更有黑甜处|泉声绕枕流
自古天难定|斯人疾久婴|止馀南牖诀|堪与暴平生
肌细分红脉|香浓破紫苞|无因留得玩|争忍折来抛
辋川题作浪|武昌栽属官|爱思如孔阶|茸髯摆奇观
半世别玉州|梦忆仙人掌|经丘获鎗旗|清思飘云上
一雨山如沐|垂藤覆深屋|不见踏花人|窗外生新绿
梅楥幽鸟鸣|山客睡初起|空斋昼无人|寒日在书几
系缆荒山下|挑灯细雨前|客心共流水|摇荡不成眠
攀藤招逸客|偃桂协幽情|水中看树影|风里听松声
田夫夜饭牛|童子朝出牧|横笛两三声|清响应山谷
每恨陶彭泽|无钱对菊花|如今九日至|自觉酒须赊
飞鸟摇岭色|渐与峰顶齐|凝眸绝涧影|巳转碧潭西
自有吾儒乐|人多不肯循|以禅为乐事|又起一重尘
漾舟入芙蓉|花乱舟攲侧|安稳此凭栏|清香生履舄
古涧横小桥|竟日无人渡|红尘隘九衢|来往不知数
名节士所重|当如护睛脑|立朝与行己|本末要可考
试问窗中客|此作何转语|光霁只在人|人人有灵府
霜飘金奏沉|风动玉声碎|可似薛家娘|秋闺鸣素佩
广文金闺身|台城一相见|壁素悬青灯|花虫蠹书卷
寂寞真龙去|雩坛血不乾|世情多冷暖|对此鼻辛酸
高冈有五石|石石皆生云|晏坐松根下|前林正夕曛
湖上清秋夜|扁舟泛碧波|紫箫吹不断|无奈月明何
世及乘朱轮|赏延端章甫|稍曾事贵游|爰居听钟鼓
去岁虽无战|今年未得归|皇恩何以报|春日得春衣
闻道成都酒|无钱亦可求|不知将几斗|销得此来愁
向晚蛩声杂|凄凄篱落边|老夫方醉卧|魂梦绕钧天
自嫌太奇绝|混以雪和月|却有一味香|教人细分别
莫使儿辈觉|从渠青紫纷|马前金罢亚|鸟外玉奫沦
多病全然懒|微凉尚未寒|偶然无一事|蛛网雨中看
高岩如被蓑|纷纷挂藤薜|下有青葱树|直上斗秋色
画师好画鬼|极力穷幽深|世亦有真鬼|画形难画心
作尉穷谷僻|官高何足论|温温有风味|忆昔李公存
巧鸟窥帘语|飞飞令客思|无情翻有意|偶对似终期
玉人隔沙渚|朱箔垂银虹|所思欲谓之|紫江淼无穷
出门复出门|致辞问老翁|郡县如猛虎|可与畴昔同
六朝迹苍莽|长江流古今|高台自风月|不废我登临
清秋气萧瑟|遥夜水崩奔|自了岩中趣|无人可共论
舟随乱石转|转转上青天|十八滩行尽|行人非少年
参差剪绿绮|潇洒覆琼柯|忆在沣东寺|偏书此叶多
旧日韶山下|人传有舜祠|滩声正鞺鞳|似奏九招时
荆棘半低垂|幽禽祇自悲|可怜栖不稳|不似上林时
易经之下卷|何以始恒咸|贞女家人利|如诗有二南
一体乾坤妙|诸君且未知|已将无限意|分付友山诗
何处堪销夏|龙舟过洞庭|谁歌采莲曲|江上越山青
慈元一片石|长留何处山|厓门潮日至|雪浪飞天关
甘菊缝为枕|疏梅画作屏|改诗眠未稳|闻雪醉初醒
去从此路去|归从此路归|一官仍故步|回首十年非
待月了残经|文义何曾有|分付与痴儿|黄叶卷在手
千顷竟何为|万竿复何处|居然五亩园|独领浣花趣
苍梧帝子游|萧瑟倚清秋|一握冰纨里|长县翡翠钩
肃羽遵寒渚|渡江芦叶黄|谁云南去远|不敢过衡阳
瓠白茄子青|软美胜粱肉|百年腐儒餐|饫饱堪鼓腹
何年此飞来|愿尔千岁住|风雨对床时|只恐又飞去
陇断沙痕浅|山空月色孤|归来夜将午|射得紫髯狐
为爱凌霜干|开花千万树|待我罗浮人|同君会心处
色相空山里|无言亘古今|嵩山面壁者|还有去来心
江头云阁雨|柳色与春深|船发春风阻|谁知客子心
中表皆称孝|舅姑忍汝劳|宾朋日夜往|龟手事香醪
已讶松生市|更将湖入城|如何造物者|百巧供先生
堆山积岳来|一一尽尘埃|更拟论玄妙|冰消解瓦摧
石洞何年有|名传事或非|那知为雨后|却向此中归
阶下多孩菊|庭前复女兰|汲泉频灌溉|持作老亲欢
美人隔江洲|咫尺不得渡|不畏石上霜|但畏草间露
前山风雨凉|歇马坐垂杨|何处芙蓉落|南渠秋水香
五月分衣节|三军受甲时|莫教麟阁将|频发羽林儿
悄悄瞻青壁|悠悠瞩翠林|流莺无一事|声远薜萝阴
我爱西湖好|何时此一行|六桥明月夜|花底画船横
苦参道难学|放肆事容易|入脚不可深|骎骎成自弃
海腹藏吴楚|天枢转斗牛|夜分惊日浴|潮落见鲸游
家住吴趋市|书传越践城|病来因染色|魂去为钟情
天若无雪霜|青松不如草|地若无山川|何人重平道
黑云埋日车|厚雪镇坤轴|行路勿匆匆|包藏恐深谷
沙田无晚稻|霜降已全收|衔穗多膏蟹|泥中拾满篝
五更金鸡唱|声声彻翠微|暤熙逢舜日|遥向凤楼飞
含啸沔阳春|孙曹不敢臣|若无三顾主|何地著斯人